":START_ID",":END_ID"
"1553","1517"
"1554","1517"
"1555","1518"
"1556","1519"
"1557","1518"
"1558","1519"
"1559","1518"
"1560","1518"
"1561","1519"
"1562","1520"
"1563","1520"
