":START_ID",":END_ID"
"1624","1628"
"1625","1629"
"1625","1630"
"1626","1631"
"1672","1636"
"1673","1637"
"1674","1638"
"1675","1639"
"1676","1640"
"1677","1641"
"1678","1642"
"1679","1643"
"1680","1644"
"1681","1645"
"1682","1646"
"1683","1647"
