":START_ID",":END_ID"
"1335","1434"
"1337","1435"
"1337","1436"
"1338","1437"
"1340","1438"
"1340","1439"
"1340","1440"
"1340","1441"
"1340","1442"
"1340","1443"
"1340","1444"
"1341","1445"
"1343","1446"
"1343","1447"
"1343","1448"
"1343","1449"
"1344","1450"
"1346","1451"
"1346","1452"
"1346","1453"
"1346","1454"
"1346","1455"
"1347","1456"
"1349","1457"
"1349","1458"
"1349","1459"
"1349","1460"
"1350","1461"
"1351","1462"
"1351","1463"
"1352","1464"
"1353","1465"
"1353","1466"
"1354","1467"
"1355","1468"
"1355","1469"
"1356","1470"
"1357","1471"
"1357","1472"
