":START_ID",":END_ID"
"1342","1333"
"1342","1334"
"1342","1335"
"1342","1336"
"1342","1337"
"1344","1338"
"1344","1339"
"1344","1340"
"1344","1341"
