":START_ID",":END_ID"
"1423","1363"
"1423","1364"
"1423","1365"
"1423","1366"
"1423","1367"
"1423","1368"
"1423","1369"
"1424","1370"
"1424","1371"
"1424","1372"
"1424","1373"
"1424","1374"
"1424","1375"
"1424","1376"
"1424","1377"
"1424","1378"
"1425","1379"
"1425","1380"
"1425","1381"
"1425","1382"
"1425","1383"
"1425","1384"
"1425","1385"
"1425","1386"
"1425","1387"
"1425","1388"
"1425","1389"
"1425","1390"
"1425","1391"
"1425","1392"
"1425","1393"
"1425","1394"
"1425","1395"
"1425","1396"
"1425","1397"
"1425","1398"
"1425","1399"
"1425","1400"
"1426","1401"
"1426","1402"
"1426","1403"
"1426","1404"
"1426","1405"
"1426","1406"
"1426","1407"
"1426","1408"
"1426","1409"
"1426","1410"
"1426","1411"
"1426","1412"
"1426","1413"
"1426","1414"
"1426","1415"
"1426","1416"
"1426","1417"
"1426","1418"
"1426","1419"
"1426","1420"
"1426","1421"
"1426","1422"
