":START_ID",":END_ID"
"1436","1582"
"1438","1583"
"1438","1584"
"1439","1585"
"1441","1586"
"1441","1587"
"1441","1588"
"1441","1589"
"1441","1590"
"1441","1591"
"1441","1592"
"1442","1593"
"1444","1594"
"1444","1595"
"1444","1596"
"1444","1597"
"1445","1598"
"1447","1599"
"1447","1600"
"1447","1601"
"1447","1602"
"1447","1603"
"1448","1604"
"1450","1605"
"1450","1606"
"1450","1607"
"1450","1608"
"1451","1609"
"1452","1610"
"1452","1611"
"1452","1612"
"1453","1613"
"1453","1614"
"1454","1615"
"1455","1616"
"1456","1617"
"1456","1618"
"1457","1619"
"1458","1620"
"1459","1621"
"1459","1622"
"1460","1623"
"1461","1624"
"1462","1625"
"1462","1626"
"1463","1627"
