":START_ID",":END_ID"
"1849","1786"
"1849","1787"
"1849","1788"
"1849","1789"
"1849","1790"
"1849","1791"
"1849","1792"
"1849","1793"
"1849","1794"
"1849","1795"
"1849","1796"
"1849","1797"
"1849","1798"
"1849","1799"
"1849","1800"
"1849","1801"
"1849","1802"
"1849","1803"
"1849","1804"
"1849","1805"
"1849","1806"
"1849","1807"
"1849","1808"
"1849","1809"
"1849","1810"
"1849","1811"
"1849","1812"
"1849","1813"
"1849","1814"
"1849","1815"
"1849","1816"
"1849","1817"
"1849","1818"
"1849","1819"
"1849","1820"
"1849","1821"
"1849","1822"
"1849","1823"
"1849","1824"
"1849","1825"
"1849","1826"
"1849","1827"
"1849","1828"
"1849","1829"
"1849","1830"
"1849","1831"
"1849","1832"
"1849","1833"
"1849","1834"
"1849","1835"
"1849","1836"
"1849","1837"
"1849","1838"
"1849","1839"
"1849","1840"
"1849","1841"
"1849","1842"
"1849","1843"
"1849","1844"
"1849","1845"
"1849","1846"
"1849","1847"
"1849","1848"
