":START_ID",":END_ID"
"1868","1805"
"1868","1806"
"1868","1807"
"1868","1808"
"1868","1809"
"1868","1810"
"1868","1811"
"1868","1812"
"1868","1813"
"1868","1814"
"1868","1815"
"1868","1816"
"1868","1817"
"1868","1818"
"1868","1819"
"1868","1820"
"1868","1821"
"1868","1822"
"1868","1823"
"1868","1824"
"1868","1825"
"1868","1826"
"1868","1827"
"1868","1828"
"1868","1829"
"1868","1830"
"1868","1831"
"1868","1832"
"1868","1833"
"1868","1834"
"1868","1835"
"1868","1836"
"1868","1837"
"1868","1838"
"1868","1839"
"1868","1840"
"1868","1841"
"1868","1842"
"1868","1843"
"1868","1844"
"1868","1845"
"1868","1846"
"1868","1847"
"1868","1848"
"1868","1849"
"1868","1850"
"1868","1851"
"1868","1852"
"1868","1853"
"1868","1854"
"1868","1855"
"1868","1856"
"1868","1857"
"1868","1858"
"1868","1859"
"1868","1860"
"1868","1861"
"1868","1862"
"1868","1863"
"1868","1864"
"1868","1865"
"1868","1866"
"1868","1867"
