":START_ID",":END_ID"
"1507","1681"
"1507","1682"
"1507","1683"
"1507","1684"
"1507","1685"
"1507","1686"
"1507","1688"
"1507","1689"
"1507","1690"
"1507","1691"
"1507","1692"
"1507","1694"
"1508","1687"
"1508","1693"
"1509","1681"
"1509","1682"
"1509","1683"
"1509","1684"
"1509","1685"
"1509","1686"
"1509","1688"
"1509","1689"
"1509","1690"
"1509","1691"
"1509","1692"
"1509","1694"
