":START_ID",":END_ID"
"1784","1783"
"1785","1784"
"1786","1785"
"1787","1786"
"1788","1787"
"1789","1788"
"1790","1789"
"1791","1790"
"1792","1791"
"1793","1792"
"1794","1793"
"1795","1794"
"1796","1795"
"1797","1796"
"1798","1797"
"1799","1798"
"1800","1799"
"1801","1800"
