":START_ID",":END_ID"
"1573","1602"
"1575","1603"
"1575","1605"
"1575","1605"
"1577","1606"
"1578","1607"
"1578","1608"
"1579","1598"
"1579","1599"
"1580","1596"
"1580","1597"
"1582","1609"
"1583","1610"
"1584","1600"
"1586","1601"
"1587","1611"
"1587","1612"
