":START_ID",":END_ID"
"1456","1392"
"1457","1393"
"1462","1394"
"1463","1395"
"1464","1396"
"1469","1397"
"1470","1398"
"1471","1399"
"1476","1400"
"1477","1401"
"1478","1402"
"1483","1403"
"1484","1404"
"1485","1405"
"1490","1406"
"1491","1407"
"1492","1408"
"1497","1409"
"1498","1410"
"1499","1411"
"1504","1412"
"1505","1413"
"1506","1414"
"1511","1415"
"1512","1416"
"1513","1417"
"1518","1418"
"1519","1419"
"1520","1420"
"1521","1421"
"1522","1422"
"1523","1423"
"1524","1424"
"1525","1425"
"1526","1426"
"1527","1427"
"1528","1428"
"1529","1429"
"1530","1430"
"1531","1431"
"1532","1432"
"1533","1433"
"1534","1434"
"1535","1435"
"1536","1436"
"1537","1437"
"1538","1438"
"1539","1439"
"1540","1440"
"1541","1441"
"1542","1442"
"1543","1443"
"1544","1444"
