":START_ID",":END_ID"
"3854","3855"
"3854","3856"
"3854","3857"
"3854","3858"
"3854","3859"
