":START_ID",":END_ID"
"1577","1633"
"1578","1634"
"1579","1635"
"1580","1636"
"1581","1637"
"1582","1638"
"1583","1638"
"1584","1638"
"1585","1639"
"1586","1640"
"1587","1640"
"1588","1640"
"1589","1640"
"1590","1640"
"1591","1641"
"1592","1641"
"1593","1641"
"1594","1642"
"1595","1642"
"1596","1642"
"1597","1643"
"1598","1643"
"1599","1643"
"1600","1643"
"1601","1643"
"1602","1643"
"1603","1643"
"1604","1643"
"1605","1644"
"1606","1644"
"1607","1644"
"1608","1645"
"1609","1645"
"1610","1646"
"1611","1646"
"1612","1646"
"1613","1647"
"1614","1647"
"1615","1647"
"1616","1647"
"1617","1648"
"1618","1648"
"1619","1648"
"1620","1648"
"1621","1649"
"1622","1649"
"1623","1649"
"1624","1649"
"1625","1649"
"1626","1649"
"1627","1649"
"1628","1649"
"1629","1649"
"1630","1649"
"1631","1649"
"1632","1649"
