":START_ID",":END_ID"
"1396","1551"
"1398","1552"
"1398","1553"
"1399","1554"
"1401","1555"
"1401","1556"
"1401","1557"
"1401","1558"
"1401","1559"
"1401","1560"
"1401","1561"
"1402","1562"
"1404","1563"
"1404","1564"
"1404","1565"
"1404","1566"
"1405","1567"
"1407","1568"
"1407","1569"
"1407","1570"
"1407","1571"
"1407","1572"
"1408","1573"
"1410","1574"
"1410","1575"
"1410","1576"
"1410","1577"
"1411","1578"
"1412","1579"
"1412","1580"
"1412","1581"
"1413","1582"
"1413","1583"
"1414","1584"
"1415","1585"
"1416","1586"
"1416","1587"
"1417","1588"
"1418","1589"
"1419","1590"
"1419","1591"
"1420","1592"
"1421","1593"
"1422","1594"
"1422","1595"
"1423","1596"
"1446","1597"
