":START_ID",":END_ID"
"1174","1134"
"1174","1135"
"1174","1136"
"1174","1137"
"1174","1138"
"1174","1139"
"1174","1140"
"1174","1141"
"1174","1142"
"1174","1143"
"1174","1144"
"1174","1145"
"1174","1146"
"1174","1147"
"1174","1148"
"1174","1149"
"1174","1150"
"1174","1151"
"1174","1152"
"1174","1153"
"1174","1154"
"1174","1155"
"1174","1156"
"1174","1157"
"1174","1158"
"1174","1159"
"1174","1160"
"1174","1161"
"1174","1162"
"1174","1163"
"1174","1164"
"1174","1165"
"1174","1166"
"1174","1167"
"1174","1168"
"1174","1169"
"1174","1170"
"1174","1171"
"1174","1172"
"1174","1173"
