":START_ID",":END_ID"
"1517","1570"
"1518","1571"
"1518","1572"
"1518","1573"
"1519","1574"
"1519","1575"
"1519","1576"
"1520","1577"
"1520","1578"
"1521","1579"
"1521","1580"
"1522","1581"
"1522","1582"
