":START_ID",":END_ID"
"1630","1683"
"1631","1684"
"1631","1685"
"1631","1686"
"1632","1687"
"1632","1688"
"1632","1689"
"1633","1690"
"1633","1691"
"1634","1692"
"1634","1693"
"1635","1694"
"1635","1695"
