":START_ID",":END_ID"
"1444","1586"
"1445","1586"
"1446","1586"
"1447","1586"
"1448","1586"
"1449","1586"
"1450","1586"
"1451","1586"
"1452","1586"
"1453","1586"
