":START_ID",":END_ID"
"1743","1772"
"1743","1783"
"1743","1784"
"1743","1785"
"1745","1773"
"1745","1775"
"1745","1775"
"1747","1776"
"1748","1777"
"1748","1778"
"1749","1768"
"1749","1769"
"1750","1766"
"1750","1767"
"1752","1779"
"1753","1780"
"1754","1770"
"1756","1771"
"1757","1781"
"1757","1782"
"1758","1786"
