":START_ID",":END_ID"
"1630","1638"
"1631","1639"
"1631","1640"
"1632","1641"
"1678","1654"
"1679","1655"
"1680","1656"
"1681","1657"
"1682","1658"
"1683","1659"
"1684","1660"
"1685","1661"
"1686","1662"
"1687","1663"
"1688","1664"
"1689","1665"
