":START_ID",":END_ID"
"1583","1570"
"1584","1570"
"1585","1570"
"1586","1570"
"1587","1570"
"1588","1570"
"1589","1572"
"1590","1581"
"1591","1570"
"1592","1570"
"1593","1571"
"1594","1572"
"1595","1573"
"1596","1581"
"1597","1570"
"1598","1573"
"1599","1581"
"1600","1570"
"1601","1573"
"1602","1581"
"1603","1570"
"1604","1571"
"1605","1572"
"1606","1573"
"1607","1574"
"1608","1577"
"1609","1579"
"1610","1581"
"1611","1570"
"1612","1573"
"1613","1581"
"1614","1570"
"1615","1573"
"1616","1574"
"1617","1577"
"1618","1579"
"1619","1571"
"1620","1574"
"1621","1577"
"1622","1579"
"1624","1574"
"1625","1577"
"1626","1581"
"1627","1570"
"1628","1571"
"1629","1572"
"1630","1573"
"1631","1574"
"1632","1575"
"1633","1576"
"1634","1577"
"1635","1578"
"1636","1579"
"1637","1580"
"1638","1581"
