":START_ID",":END_ID"
"1668","1622"
"1669","1623"
"1670","1622"
"1671","1623"
"1672","1622"
"1673","1623"
"1674","1622"
"1675","1622"
"1676","1623"
"1677","1622"
"1678","1623"
