":START_ID",":END_ID"
"1423","1377"
"1424","1378"
"1425","1377"
"1426","1378"
"1427","1377"
"1428","1378"
"1429","1377"
"1430","1377"
"1431","1378"
"1432","1377"
"1433","1378"
