":START_ID",":END_ID"
"3625","3612"
"3626","3613"
"3627","3614"
"3628","3615"
"3629","3616"
"3630","3617"
"3630","3618"
"3631","3619"
"3632","3620"
