":START_ID",":END_ID"
"1563","1582"
"1571","1583"
"1571","1584"
"1572","1583"
"1572","1584"
"1577","1586"
"1578","1587"
