":START_ID",":END_ID"
"1698","1662"
"1699","1662"
"1700","1663"
"1701","1664"
"1702","1663"
"1703","1664"
"1704","1663"
"1705","1663"
"1706","1664"
"1707","1665"
"1708","1665"
