":START_ID",":END_ID"
"1373","1337"
"1374","1338"
"1379","1339"
"1380","1340"
"1381","1341"
"1386","1342"
"1387","1343"
"1388","1344"
"1393","1345"
"1394","1346"
"1395","1347"
"1400","1348"
"1401","1349"
"1402","1350"
"1407","1351"
"1408","1352"
"1409","1353"
"1414","1354"
"1415","1355"
"1416","1356"
"1421","1357"
"1422","1358"
"1423","1359"
"1428","1360"
"1429","1361"
"1430","1362"
"1435","1363"
