":START_ID",":END_ID"
"1660","1614"
"1661","1615"
"1662","1614"
"1663","1615"
"1664","1614"
"1665","1615"
"1666","1614"
"1667","1614"
"1668","1615"
"1669","1614"
"1670","1615"
