":START_ID",":END_ID"
"1314","1296"
"1315","1297"
"1316","1298"
"1317","1299"
"1318","1300"
"1319","1301"
"1320","1302"
"1320","1303"
"1321","1304"
"1322","1305"
"1323","1306"
"1324","1307"
"1325","1308"
"1326","1309"
"1327","1310"
"1328","1311"
"1328","1312"
"1329","1313"
