":START_ID",":END_ID"
"1491","1555"
"1491","1556"
"1491","1557"
"1491","1558"
"1491","1559"
"1491","1560"
"1491","1561"
"1491","1562"
"1491","1563"
"1491","1564"
"1491","1565"
