":START_ID",":END_ID"
"3829","3830"
"3829","3831"
"3829","3832"
"3829","3833"
"3829","3834"
"3829","3835"
