":START_ID",":END_ID"
"1514","1688"
"1514","1689"
"1514","1690"
"1514","1691"
"1514","1692"
"1514","1693"
"1514","1695"
"1514","1696"
"1514","1697"
"1514","1698"
"1514","1699"
"1514","1701"
"1515","1694"
"1515","1700"
"1516","1688"
"1516","1689"
"1516","1690"
"1516","1691"
"1516","1692"
"1516","1693"
"1516","1695"
"1516","1696"
"1516","1697"
"1516","1698"
"1516","1699"
"1516","1701"
