":START_ID",":END_ID"
"3853","3862"
"3853","3861"
"3853","3864"
"3853","3863"
"3853","3860"
"3854","3856"
"3854","3857"
"3854","3858"
"3854","3855"
"3854","3859"
