":START_ID",":END_ID"
"1447","1451"
"1448","1452"
"1448","1453"
"1449","1454"
"1495","1459"
"1496","1460"
"1497","1461"
"1498","1462"
"1499","1463"
"1500","1464"
"1501","1465"
"1502","1466"
"1503","1467"
"1504","1468"
"1505","1469"
"1506","1470"
