":START_ID",":END_ID"
"1510","1684"
"1510","1685"
"1510","1686"
"1510","1687"
"1510","1688"
"1510","1689"
"1510","1691"
"1510","1692"
"1510","1693"
"1510","1694"
"1510","1695"
"1510","1697"
"1511","1690"
"1511","1696"
"1512","1684"
"1512","1685"
"1512","1686"
"1512","1687"
"1512","1688"
"1512","1689"
"1512","1691"
"1512","1692"
"1512","1693"
"1512","1694"
"1512","1695"
"1512","1697"
