":START_ID",":END_ID"
"1347","1348"
"1347","1349"
"1347","1350"
"1347","1351"
"1347","1352"
"1347","1353"
"1347","1354"
