":START_ID",":END_ID"
"25","26"
"25","27"
"25","28"
"30","31"
"30","32"
"30","25"
"30","33"
"30","34"
"34","35"
"34","36"
"34","37"
"30","38"
"38","39"
"30","40"
"40","41"
"40","42"
"40","43"
"40","37"
"30","44"
"30","45"
"46","47"
"46","48"
"46","49"
"46","50"
"46","51"
"46","33"
"46","52"
"46","53"
"46","25"
"46","54"
"46","55"
"46","56"
"46","57"
"46","58"
"46","59"
"59","60"
"59","61"
"59","62"
"46","29"
"46","38"
"38","39"
"46","63"
"63","64"
"63","65"
"46","66"
"46","67"
"67","68"
"67","69"
"67","70"
"67","71"
"67","72"
"67","73"
"74","75"
"74","29"
"74","57"
"74","52"
"74","45"
"74","76"
"74","77"
"74","78"
"74","79"
"79","80"
"79","81"
"74","82"
"74","83"
"74","84"
"74","85"
"85","86"
"85","87"
"85","88"
"74","25"
