":START_ID",":END_ID"
"28","19"
"29","20"
"30","21"
"31","22"
"52","23"
"70","24"
"70","25"
