":START_ID",":END_ID"
"1624","1677"
"1625","1678"
"1625","1679"
"1625","1680"
"1626","1681"
"1626","1682"
"1626","1683"
"1627","1684"
"1627","1685"
"1628","1686"
"1628","1687"
"1629","1688"
"1629","1689"
