":START_ID",":END_ID"
"1447","1405"
"1448","1405"
"1449","1406"
"1450","1406"
"1451","1407"
"1452","1406"
"1453","1408"
"1454","1409"
"1455","1409"
"1456","1410"
"1457","1410"
