":START_ID",":END_ID"
"1674","1730"
"1675","1731"
"1676","1732"
"1677","1733"
"1678","1734"
"1679","1735"
"1680","1735"
"1681","1735"
"1682","1736"
"1683","1737"
"1684","1737"
"1685","1737"
"1686","1737"
"1687","1737"
"1688","1738"
"1689","1738"
"1690","1738"
"1691","1739"
"1692","1739"
"1693","1739"
"1694","1740"
"1695","1740"
"1696","1740"
"1697","1740"
"1698","1740"
"1699","1740"
"1700","1740"
"1701","1740"
"1702","1741"
"1703","1741"
"1704","1741"
"1705","1742"
"1706","1742"
"1707","1743"
"1708","1743"
"1709","1743"
"1710","1744"
"1711","1744"
"1712","1744"
"1713","1744"
"1714","1745"
"1715","1745"
"1716","1745"
"1717","1745"
"1718","1746"
"1719","1746"
"1720","1746"
"1721","1746"
"1722","1746"
"1723","1746"
"1724","1746"
"1725","1746"
"1726","1746"
"1727","1746"
"1728","1746"
"1729","1746"
