":START_ID",":END_ID"
"3815","3816"
"3815","3817"
"3815","3818"
"3815","3819"
"3815","3820"
"3815","3821"
