":START_ID",":END_ID"
"3832","3819"
"3833","3820"
"3834","3821"
"3835","3822"
"3836","3823"
"3837","3824"
"3837","3825"
"3838","3826"
"3839","3827"
