":START_ID",":END_ID"
"1595","1601"
"1595","1602"
"1595","1603"
"1594","1604"
"1594","1605"
"1594","1606"
"1599","1608"
"1598","1609"
"1599","1610"
