":START_ID",":END_ID"
"1702","1660"
"1703","1660"
"1704","1661"
"1705","1661"
"1706","1662"
"1707","1661"
"1708","1663"
"1709","1664"
"1710","1664"
"1711","1665"
"1712","1665"
