":START_ID",":END_ID"
"1637","1666"
"1637","1677"
"1637","1678"
"1637","1679"
"1639","1667"
"1639","1669"
"1639","1669"
"1641","1670"
"1642","1671"
"1642","1672"
"1643","1662"
"1643","1663"
"1644","1660"
"1644","1661"
"1646","1673"
"1647","1674"
"1648","1664"
"1650","1665"
"1651","1675"
"1651","1676"
