":START_ID",":END_ID"
"1726","1745"
"1734","1746"
"1734","1747"
"1735","1746"
"1735","1747"
"1740","1749"
"1741","1750"
