":START_ID",":END_ID"
"1630","1634"
"1631","1635"
"1631","1636"
"1632","1637"
"1678","1642"
"1679","1643"
"1680","1644"
"1681","1645"
"1682","1646"
"1683","1647"
"1684","1648"
"1685","1649"
"1686","1650"
"1687","1651"
"1688","1652"
"1689","1653"
