":START_ID",":END_ID"
"3828","3829"
"3828","3830"
"3828","3831"
"3828","3832"
"3828","3833"
"3828","3834"
