":START_ID",":END_ID"
"3814","3815"
"3814","3816"
"3814","3817"
"3814","3818"
"3814","3819"
"3814","3820"
