":START_ID",":END_ID"
"1355","1361"
"1355","1362"
"1355","1363"
"1354","1364"
"1354","1365"
"1354","1366"
"1359","1368"
"1358","1369"
"1359","1370"
