":START_ID",":END_ID"
"1752","1782"
"1752","1793"
"1752","1794"
"1752","1795"
"1754","1783"
"1754","1785"
"1754","1785"
"1756","1786"
"1757","1787"
"1757","1788"
"1758","1778"
"1758","1779"
"1759","1776"
"1759","1777"
"1761","1789"
"1762","1790"
"1763","1780"
"1765","1781"
"1766","1791"
"1766","1792"
"1767","1796"
"1769","1797"
