":START_ID",":END_ID"
"1488","1494"
"1488","1495"
"1488","1496"
"1487","1497"
"1487","1498"
"1487","1499"
"1492","1501"
"1491","1502"
"1492","1503"
