":START_ID",":END_ID"
"1396","1400"
"1397","1401"
"1397","1402"
"1398","1403"
"1444","1408"
"1445","1409"
"1446","1410"
"1447","1411"
"1448","1412"
"1449","1413"
"1450","1414"
"1451","1415"
"1452","1416"
"1453","1417"
"1454","1418"
"1455","1419"
