":START_ID",":END_ID"
"1563","1521"
"1564","1521"
"1565","1522"
"1566","1522"
"1567","1523"
"1568","1522"
"1569","1524"
"1570","1525"
"1571","1525"
"1572","1526"
"1573","1526"
