":START_ID",":END_ID"
"1608","1672"
"1608","1673"
"1608","1674"
"1608","1675"
"1608","1676"
"1608","1677"
"1608","1678"
"1608","1679"
"1608","1680"
"1608","1681"
"1608","1682"
