":START_ID",":END_ID"
"1444","1431"
"1445","1431"
"1446","1431"
"1447","1431"
"1448","1431"
"1449","1431"
"1450","1433"
"1451","1442"
"1452","1431"
"1453","1431"
"1454","1432"
"1455","1433"
"1456","1434"
"1457","1442"
"1458","1431"
"1459","1434"
"1460","1442"
"1461","1431"
"1462","1434"
"1463","1442"
"1464","1431"
"1465","1432"
"1466","1433"
"1467","1434"
"1468","1435"
"1469","1438"
"1470","1440"
"1471","1442"
"1472","1431"
"1473","1434"
"1474","1442"
"1475","1431"
"1476","1434"
"1477","1435"
"1478","1438"
"1479","1440"
"1480","1432"
"1481","1435"
"1482","1438"
"1483","1440"
"1485","1435"
"1486","1438"
"1487","1442"
"1488","1431"
"1489","1432"
"1490","1433"
"1491","1434"
"1492","1435"
"1493","1436"
"1494","1437"
"1495","1438"
"1496","1439"
"1497","1440"
"1498","1441"
"1499","1442"
