":START_ID",":END_ID"
"1670","1726"
"1671","1727"
"1672","1728"
"1673","1729"
"1674","1730"
"1675","1731"
"1676","1731"
"1677","1731"
"1678","1732"
"1679","1733"
"1680","1733"
"1681","1733"
"1682","1733"
"1683","1733"
"1684","1734"
"1685","1734"
"1686","1734"
"1687","1735"
"1688","1735"
"1689","1735"
"1690","1736"
"1691","1736"
"1692","1736"
"1693","1736"
"1694","1736"
"1695","1736"
"1696","1736"
"1697","1736"
"1698","1737"
"1699","1737"
"1700","1737"
"1701","1738"
"1702","1738"
"1703","1739"
"1704","1739"
"1705","1739"
"1706","1740"
"1707","1740"
"1708","1740"
"1709","1740"
"1710","1741"
"1711","1741"
"1712","1741"
"1713","1741"
"1714","1742"
"1715","1742"
"1716","1742"
"1717","1742"
"1718","1742"
"1719","1742"
"1720","1742"
"1721","1742"
"1722","1742"
"1723","1742"
"1724","1742"
"1725","1742"
