":START_ID",":END_ID"
"1513","1566"
"1514","1567"
"1514","1568"
"1514","1569"
"1515","1570"
"1515","1571"
"1515","1572"
"1516","1573"
"1516","1574"
"1517","1575"
"1517","1576"
"1518","1577"
"1518","1578"
