":START_ID",":END_ID"
"1639","1658"
"1647","1659"
"1647","1660"
"1648","1659"
"1648","1660"
"1653","1662"
"1654","1663"
