":START_ID",":END_ID"
"1365","1374"
"1366","1381"
"1367","1388"
"1368","1395"
"1369","1402"
"1370","1409"
"1371","1416"
"1372","1423"
"1373","1430"
