":START_ID",":END_ID"
"1364","1481"
"1365","1481"
"1366","1481"
"1367","1481"
"1368","1481"
"1369","1481"
"1370","1481"
"1371","1481"
"1372","1481"
