":START_ID",":END_ID"
"1647","1584"
"1647","1585"
"1647","1586"
"1647","1587"
"1647","1588"
"1647","1589"
"1647","1590"
"1647","1591"
"1647","1592"
"1647","1593"
"1647","1594"
"1647","1595"
"1647","1596"
"1647","1597"
"1647","1598"
"1647","1599"
"1647","1600"
"1647","1601"
"1647","1602"
"1647","1603"
"1647","1604"
"1647","1605"
"1647","1606"
"1647","1607"
"1647","1608"
"1647","1609"
"1647","1610"
"1647","1611"
"1647","1612"
"1647","1613"
"1647","1614"
"1647","1615"
"1647","1616"
"1647","1617"
"1647","1618"
"1647","1619"
"1647","1620"
"1647","1621"
"1647","1622"
"1647","1623"
"1647","1624"
"1647","1625"
"1647","1626"
"1647","1627"
"1647","1628"
"1647","1629"
"1647","1630"
"1647","1631"
"1647","1632"
"1647","1633"
"1647","1634"
"1647","1635"
"1647","1636"
"1647","1637"
"1647","1638"
"1647","1639"
"1647","1640"
"1647","1641"
"1647","1642"
"1647","1643"
"1647","1644"
"1647","1645"
"1647","1646"
