":START_ID",":END_ID"
"1447","1411"
"1448","1411"
"1449","1412"
"1450","1413"
"1451","1412"
"1452","1413"
"1453","1412"
"1454","1412"
"1455","1413"
"1456","1414"
"1457","1414"
