":START_ID",":END_ID"
"1455","1464"
"1455","1465"
"1455","1466"
"1455","1467"
"1455","1468"
"1455","1469"
"1455","1470"
"1456","1471"
"1456","1472"
"1456","1473"
"1456","1474"
"1456","1475"
"1456","1476"
"1456","1477"
"1457","1478"
"1457","1479"
"1457","1480"
"1457","1481"
"1457","1482"
"1457","1483"
"1457","1484"
"1458","1485"
"1458","1486"
"1458","1487"
"1458","1488"
"1458","1489"
"1458","1490"
"1458","1491"
"1459","1492"
"1459","1493"
"1459","1494"
"1459","1495"
"1459","1496"
"1459","1497"
"1459","1498"
"1460","1499"
"1460","1500"
"1460","1501"
"1460","1502"
"1460","1503"
"1460","1504"
"1460","1505"
"1461","1506"
"1461","1507"
"1461","1508"
"1461","1509"
"1461","1510"
"1461","1511"
"1461","1512"
"1462","1513"
"1462","1514"
"1462","1515"
"1462","1516"
"1462","1517"
"1462","1518"
"1462","1519"
"1463","1520"
"1463","1521"
"1463","1522"
"1463","1523"
"1463","1524"
"1463","1525"
"1463","1526"
