":START_ID",":END_ID"
"1524","1553"
"1526","1554"
"1526","1556"
"1526","1556"
"1528","1557"
"1529","1558"
"1529","1559"
"1530","1549"
"1530","1550"
"1531","1547"
"1531","1548"
"1533","1560"
"1534","1561"
"1535","1551"
"1537","1552"
"1538","1562"
"1538","1563"
