":START_ID",":END_ID"
"1637","1636"
"1638","1637"
"1639","1638"
"1640","1639"
"1641","1640"
"1642","1641"
"1643","1642"
"1644","1643"
"1645","1644"
"1646","1645"
"1647","1646"
"1648","1647"
"1649","1648"
"1650","1649"
"1651","1650"
"1652","1651"
"1653","1652"
"1654","1653"
