":START_ID",":END_ID"
"1634","1698"
"1634","1699"
"1634","1700"
"1634","1701"
"1634","1702"
"1634","1703"
"1634","1704"
"1634","1705"
"1634","1706"
"1634","1707"
"1634","1708"
