":START_ID",":END_ID"
"1564","1563"
"1565","1564"
"1566","1565"
"1567","1566"
"1568","1567"
"1569","1568"
"1570","1569"
"1571","1570"
"1572","1571"
"1573","1572"
"1574","1573"
"1575","1574"
"1576","1575"
"1577","1576"
"1578","1577"
"1579","1578"
"1580","1579"
"1581","1580"
