":START_ID",":END_ID"
"1392","1545"
"1394","1546"
"1394","1547"
"1395","1548"
"1397","1549"
"1397","1550"
"1397","1551"
"1397","1552"
"1397","1553"
"1397","1554"
"1397","1555"
"1398","1556"
"1400","1557"
"1400","1558"
"1400","1559"
"1400","1560"
"1401","1561"
"1403","1562"
"1403","1563"
"1403","1564"
"1403","1565"
"1403","1566"
"1404","1567"
"1406","1568"
"1406","1569"
"1406","1570"
"1406","1571"
"1407","1572"
"1408","1573"
"1408","1574"
"1408","1575"
"1409","1576"
"1409","1577"
"1410","1578"
"1411","1579"
"1412","1580"
"1412","1581"
"1413","1582"
"1414","1583"
"1415","1584"
"1415","1585"
"1416","1586"
"1417","1587"
"1418","1588"
"1418","1589"
"1419","1590"
"1442","1591"
