":START_ID",":END_ID"
"1362","1371"
"1363","1378"
"1364","1385"
"1365","1392"
"1366","1399"
"1367","1406"
"1368","1413"
"1369","1420"
"1370","1427"
