":START_ID",":END_ID"
"1901","1838"
"1901","1839"
"1901","1840"
"1901","1841"
"1901","1842"
"1901","1843"
"1901","1844"
"1901","1845"
"1901","1846"
"1901","1847"
"1901","1848"
"1901","1849"
"1901","1850"
"1901","1851"
"1901","1852"
"1901","1853"
"1901","1854"
"1901","1855"
"1901","1856"
"1901","1857"
"1901","1858"
"1901","1859"
"1901","1860"
"1901","1861"
"1901","1862"
"1901","1863"
"1901","1864"
"1901","1865"
"1901","1866"
"1901","1867"
"1901","1868"
"1901","1869"
"1901","1870"
"1901","1871"
"1901","1872"
"1901","1873"
"1901","1874"
"1901","1875"
"1901","1876"
"1901","1877"
"1901","1878"
"1901","1879"
"1901","1880"
"1901","1881"
"1901","1882"
"1901","1883"
"1901","1884"
"1901","1885"
"1901","1886"
"1901","1887"
"1901","1888"
"1901","1889"
"1901","1890"
"1901","1891"
"1901","1892"
"1901","1893"
"1901","1894"
"1901","1895"
"1901","1896"
"1901","1897"
"1901","1898"
"1901","1899"
"1901","1900"
