":START_ID",":END_ID"
"1642","1579"
"1642","1580"
"1642","1581"
"1642","1582"
"1642","1583"
"1642","1584"
"1642","1585"
"1642","1586"
"1642","1587"
"1642","1588"
"1642","1589"
"1642","1590"
"1642","1591"
"1642","1592"
"1642","1593"
"1642","1594"
"1642","1595"
"1642","1596"
"1642","1597"
"1642","1598"
"1642","1599"
"1642","1600"
"1642","1601"
"1642","1602"
"1642","1603"
"1642","1604"
"1642","1605"
"1642","1606"
"1642","1607"
"1642","1608"
"1642","1609"
"1642","1610"
"1642","1611"
"1642","1612"
"1642","1613"
"1642","1614"
"1642","1615"
"1642","1616"
"1642","1617"
"1642","1618"
"1642","1619"
"1642","1620"
"1642","1621"
"1642","1622"
"1642","1623"
"1642","1624"
"1642","1625"
"1642","1626"
"1642","1627"
"1642","1628"
"1642","1629"
"1642","1630"
"1642","1631"
"1642","1632"
"1642","1633"
"1642","1634"
"1642","1635"
"1642","1636"
"1642","1637"
"1642","1638"
"1642","1639"
"1642","1640"
"1642","1641"
