":START_ID",":END_ID"
"1330","1314"
"1330","1315"
"1330","1316"
"1330","1317"
"1330","1318"
"1330","1319"
"1330","1320"
"1331","1321"
"1331","1322"
"1331","1323"
"1331","1324"
"1331","1325"
"1331","1326"
"1331","1327"
"1331","1328"
"1331","1329"
