":START_ID",":END_ID"
"1579","1566"
"1580","1566"
"1581","1566"
"1582","1566"
"1583","1566"
"1584","1566"
"1585","1568"
"1586","1577"
"1587","1566"
"1588","1566"
"1589","1567"
"1590","1568"
"1591","1569"
"1592","1577"
"1593","1566"
"1594","1569"
"1595","1577"
"1596","1566"
"1597","1569"
"1598","1577"
"1599","1566"
"1600","1567"
"1601","1568"
"1602","1569"
"1603","1570"
"1604","1573"
"1605","1575"
"1606","1577"
"1607","1566"
"1608","1569"
"1609","1577"
"1610","1566"
"1611","1569"
"1612","1570"
"1613","1573"
"1614","1575"
"1615","1567"
"1616","1570"
"1617","1573"
"1618","1575"
"1620","1570"
"1621","1573"
"1622","1577"
"1623","1566"
"1624","1567"
"1625","1568"
"1626","1569"
"1627","1570"
"1628","1571"
"1629","1572"
"1630","1573"
"1631","1574"
"1632","1575"
"1633","1576"
"1634","1577"
