":START_ID",":END_ID"
"1666","1620"
"1667","1621"
"1668","1620"
"1669","1621"
"1670","1620"
"1671","1621"
"1672","1620"
"1673","1620"
"1674","1621"
"1675","1620"
"1676","1621"
