":START_ID",":END_ID"
"1358","1364"
"1358","1365"
"1358","1366"
"1357","1367"
"1357","1368"
"1357","1369"
"1362","1371"
"1361","1372"
"1362","1373"
