":START_ID",":END_ID"
"1142","1128"
"1142","1129"
"1142","1130"
"1142","1131"
"1142","1132"
"1142","1133"
"1142","1134"
"1142","1135"
"1142","1136"
"1142","1137"
"1142","1138"
"1142","1139"
"1142","1140"
"1142","1141"
