":START_ID",":END_ID"
"1725","1712"
"1726","1712"
"1727","1712"
"1728","1712"
"1729","1712"
"1730","1712"
"1731","1714"
"1732","1723"
"1733","1712"
"1734","1712"
"1735","1713"
"1736","1714"
"1737","1715"
"1738","1723"
"1739","1712"
"1740","1715"
"1741","1723"
"1742","1712"
"1743","1715"
"1744","1723"
"1745","1712"
"1746","1713"
"1747","1714"
"1748","1715"
"1749","1716"
"1750","1719"
"1751","1721"
"1752","1723"
"1753","1712"
"1754","1715"
"1755","1723"
"1756","1712"
"1757","1715"
"1758","1716"
"1759","1719"
"1760","1721"
"1761","1713"
"1762","1716"
"1763","1719"
"1764","1721"
"1766","1716"
"1767","1719"
"1768","1723"
"1769","1712"
"1770","1713"
"1771","1714"
"1772","1715"
"1773","1716"
"1774","1717"
"1775","1718"
"1776","1719"
"1777","1720"
"1778","1721"
"1779","1722"
"1780","1723"
