":START_ID",":END_ID"
"1456","1467"
"1456","1468"
"1456","1469"
"1456","1470"
"1456","1471"
"1456","1472"
"1456","1473"
"1457","1474"
"1457","1475"
"1457","1476"
"1458","1477"
"1458","1478"
"1458","1479"
"1459","1480"
"1459","1481"
"1459","1482"
"1459","1483"
"1459","1484"
"1459","1485"
"1459","1486"
"1460","1487"
"1460","1488"
"1460","1489"
"1461","1490"
"1461","1491"
"1461","1492"
"1461","1493"
"1461","1494"
"1461","1495"
"1461","1496"
"1462","1497"
"1462","1498"
"1462","1499"
"1462","1500"
"1462","1501"
"1462","1502"
"1462","1503"
"1463","1504"
"1463","1505"
"1463","1506"
"1463","1507"
"1463","1508"
"1463","1509"
"1463","1510"
"1464","1511"
"1464","1512"
"1464","1513"
"1464","1514"
"1464","1515"
"1464","1516"
"1464","1517"
"1465","1518"
"1465","1519"
"1465","1520"
"1465","1521"
"1465","1522"
"1465","1523"
"1465","1524"
"1465","1525"
"1465","1526"
"1465","1527"
"1465","1528"
"1465","1529"
"1465","1530"
"1465","1531"
"1465","1532"
"1465","1533"
"1465","1534"
"1465","1535"
"1465","1536"
"1465","1537"
"1465","1538"
"1465","1539"
"1465","1540"
"1466","1541"
"1466","1542"
"1466","1543"
"1466","1544"
