":START_ID",":END_ID"
"31","19"
"32","20"
"33","21"
"34","22"
"37","23"
"38","24"
"51","25"
"57","26"
"75","27"
"75","28"
