":START_ID",":END_ID"
"1432","1578"
"1434","1579"
"1434","1580"
"1435","1581"
"1437","1582"
"1437","1583"
"1437","1584"
"1437","1585"
"1437","1586"
"1437","1587"
"1437","1588"
"1438","1589"
"1440","1590"
"1440","1591"
"1440","1592"
"1440","1593"
"1441","1594"
"1443","1595"
"1443","1596"
"1443","1597"
"1443","1598"
"1443","1599"
"1444","1600"
"1446","1601"
"1446","1602"
"1446","1603"
"1446","1604"
"1447","1605"
"1448","1606"
"1448","1607"
"1448","1608"
"1449","1609"
"1449","1610"
"1450","1611"
"1451","1612"
"1452","1613"
"1452","1614"
"1453","1615"
"1454","1616"
"1455","1617"
"1455","1618"
"1456","1619"
"1457","1620"
"1458","1621"
"1458","1622"
"1459","1623"
