":START_ID",":END_ID"
"1527","1535"
"1528","1536"
"1528","1537"
"1529","1538"
"1575","1551"
"1576","1552"
"1577","1553"
"1578","1554"
"1579","1555"
"1580","1556"
"1581","1557"
"1582","1558"
"1583","1559"
"1584","1560"
"1585","1561"
"1586","1562"
