":START_ID",":END_ID"
"1783","1802"
"1791","1803"
"1791","1804"
"1792","1803"
"1792","1804"
"1797","1806"
"1798","1807"
