":START_ID",":END_ID"
"1113","1091"
"1113","1092"
"1113","1093"
"1113","1094"
"1113","1095"
"1113","1096"
"1113","1097"
"1113","1098"
"1113","1099"
"1113","1100"
"1113","1101"
"1113","1102"
"1113","1103"
"1113","1104"
"1113","1105"
"1113","1106"
"1113","1107"
"1113","1108"
"1113","1109"
"1113","1110"
"1113","1111"
"1113","1112"
