":START_ID",":END_ID"
"1579","1635"
"1580","1636"
"1581","1637"
"1582","1638"
"1583","1639"
"1584","1640"
"1585","1640"
"1586","1640"
"1587","1641"
"1588","1642"
"1589","1642"
"1590","1642"
"1591","1642"
"1592","1642"
"1593","1643"
"1594","1643"
"1595","1643"
"1596","1644"
"1597","1644"
"1598","1644"
"1599","1645"
"1600","1645"
"1601","1645"
"1602","1645"
"1603","1645"
"1604","1645"
"1605","1645"
"1606","1645"
"1607","1646"
"1608","1646"
"1609","1646"
"1610","1647"
"1611","1647"
"1612","1648"
"1613","1648"
"1614","1648"
"1615","1649"
"1616","1649"
"1617","1649"
"1618","1649"
"1619","1650"
"1620","1650"
"1621","1650"
"1622","1650"
"1623","1651"
"1624","1651"
"1625","1651"
"1626","1651"
"1627","1651"
"1628","1651"
"1629","1651"
"1630","1651"
"1631","1651"
"1632","1651"
"1633","1651"
"1634","1651"
