":START_ID",":END_ID"
"1668","1626"
"1669","1626"
"1670","1627"
"1671","1627"
"1672","1628"
"1673","1627"
"1674","1629"
"1675","1630"
"1676","1630"
"1677","1631"
"1678","1631"
