":START_ID",":END_ID"
"1365","1371"
"1365","1372"
"1365","1373"
"1364","1374"
"1364","1375"
"1364","1376"
"1369","1378"
"1368","1379"
"1369","1380"
