":START_ID",":END_ID"
"1666","1674"
"1667","1675"
"1667","1676"
"1668","1677"
"1714","1690"
"1715","1691"
"1716","1692"
"1717","1693"
"1718","1694"
"1719","1695"
"1720","1696"
"1721","1697"
"1722","1698"
"1723","1699"
"1724","1700"
"1725","1701"
