":START_ID",":END_ID"
"3693","3680"
"3694","3681"
"3695","3682"
"3696","3683"
"3697","3684"
"3698","3685"
"3698","3686"
"3699","3687"
"3700","3688"
