":START_ID",":END_ID"
"3","18"
"3","17"
"3","20"
"3","19"
"3","16"
"4","12"
"4","13"
"4","14"
"4","11"
"4","15"
"5","10"
"6","9"
"7","8"
