":START_ID",":END_ID"
"1522","1541"
"1530","1542"
"1530","1543"
"1531","1542"
"1531","1543"
"1536","1545"
"1537","1546"
