":START_ID",":END_ID"
"1335","1382"
"1337","1383"
"1337","1384"
"1338","1385"
"1339","1386"
"1339","1387"
"1339","1388"
"1339","1389"
"1339","1390"
"1339","1391"
"1339","1392"
"1340","1393"
"1341","1394"
"1341","1395"
"1341","1396"
"1341","1397"
"1342","1398"
"1343","1399"
"1343","1400"
"1343","1401"
"1343","1402"
"1343","1403"
"1344","1404"
"1345","1405"
"1345","1406"
"1345","1407"
"1345","1408"
