":START_ID",":END_ID"
"3865","3874"
"3865","3873"
"3865","3876"
"3865","3875"
"3865","3872"
"3866","3868"
"3866","3869"
"3866","3870"
"3866","3867"
"3866","3871"
