":START_ID",":END_ID"
"1601","1607"
"1601","1608"
"1601","1609"
"1600","1610"
"1600","1611"
"1600","1612"
"1605","1614"
"1604","1615"
"1605","1616"
