":START_ID",":END_ID"
"1646","1604"
"1647","1604"
"1648","1605"
"1649","1605"
"1650","1606"
"1651","1605"
"1652","1607"
"1653","1608"
"1654","1608"
"1655","1609"
"1656","1609"
