":START_ID",":END_ID"
"1646","1610"
"1647","1610"
"1648","1611"
"1649","1612"
"1650","1611"
"1651","1612"
"1652","1611"
"1653","1611"
"1654","1612"
"1655","1613"
"1656","1613"
