":START_ID",":END_ID"
"1725","1781"
"1726","1782"
"1727","1783"
"1728","1784"
"1729","1785"
"1730","1786"
"1731","1786"
"1732","1786"
"1733","1787"
"1734","1788"
"1735","1788"
"1736","1788"
"1737","1788"
"1738","1788"
"1739","1789"
"1740","1789"
"1741","1789"
"1742","1790"
"1743","1790"
"1744","1790"
"1745","1791"
"1746","1791"
"1747","1791"
"1748","1791"
"1749","1791"
"1750","1791"
"1751","1791"
"1752","1791"
"1753","1792"
"1754","1792"
"1755","1792"
"1756","1793"
"1757","1793"
"1758","1794"
"1759","1794"
"1760","1794"
"1761","1795"
"1762","1795"
"1763","1795"
"1764","1795"
"1765","1796"
"1766","1796"
"1767","1796"
"1768","1796"
"1769","1797"
"1770","1797"
"1771","1797"
"1772","1797"
"1773","1797"
"1774","1797"
"1775","1797"
"1776","1797"
"1777","1797"
"1778","1797"
"1779","1797"
"1780","1797"
