":START_ID",":END_ID"
"1367","1373"
"1367","1374"
"1367","1375"
"1366","1376"
"1366","1377"
"1366","1378"
"1371","1380"
"1370","1381"
"1371","1382"
