":START_ID",":END_ID"
"1316","1298"
"1317","1299"
"1318","1300"
"1319","1301"
"1320","1302"
"1321","1303"
"1322","1304"
"1322","1305"
"1323","1306"
"1324","1307"
"1325","1308"
"1326","1309"
"1327","1310"
"1328","1311"
"1329","1312"
"1330","1313"
"1330","1314"
"1331","1315"
