":START_ID",":END_ID"
"1762","1699"
"1762","1700"
"1762","1701"
"1762","1702"
"1762","1703"
"1762","1704"
"1762","1705"
"1762","1706"
"1762","1707"
"1762","1708"
"1762","1709"
"1762","1710"
"1762","1711"
"1762","1712"
"1762","1713"
"1762","1714"
"1762","1715"
"1762","1716"
"1762","1717"
"1762","1718"
"1762","1719"
"1762","1720"
"1762","1721"
"1762","1722"
"1762","1723"
"1762","1724"
"1762","1725"
"1762","1726"
"1762","1727"
"1762","1728"
"1762","1729"
"1762","1730"
"1762","1731"
"1762","1732"
"1762","1733"
"1762","1734"
"1762","1735"
"1762","1736"
"1762","1737"
"1762","1738"
"1762","1739"
"1762","1740"
"1762","1741"
"1762","1742"
"1762","1743"
"1762","1744"
"1762","1745"
"1762","1746"
"1762","1747"
"1762","1748"
"1762","1749"
"1762","1750"
"1762","1751"
"1762","1752"
"1762","1753"
"1762","1754"
"1762","1755"
"1762","1756"
"1762","1757"
"1762","1758"
"1762","1759"
"1762","1760"
"1762","1761"
