":START_ID",":END_ID"
"31","32"
"31","33"
"31","34"
"35","36"
"35","37"
"39","35"
"39","40"
"39","31"
"39","41"
"39","42"
"42","43"
"42","44"
"42","45"
"39","46"
"46","47"
"39","48"
"48","49"
"48","50"
"48","51"
"48","45"
"39","52"
"39","53"
"54","55"
"54","56"
"54","57"
"54","58"
"54","59"
"54","41"
"54","60"
"54","61"
"54","31"
"54","62"
"54","63"
"54","64"
"54","65"
"54","66"
"54","67"
"67","68"
"67","69"
"67","70"
"54","38"
"54","46"
"46","47"
"54","71"
"71","72"
"71","73"
"54","74"
"54","75"
"75","76"
"75","77"
"75","78"
"75","79"
"75","80"
"75","81"
"82","83"
"82","38"
"82","65"
"82","60"
"82","53"
"82","84"
"82","85"
"82","86"
"82","87"
"87","88"
"87","89"
"82","90"
"82","91"
"82","92"
"82","93"
"82","31"
"82","35"
