":START_ID",":END_ID"
"1087","1077"
"1087","1078"
"1087","1079"
"1087","1080"
"1087","1081"
"1087","1082"
"1087","1083"
"1087","1084"
"1087","1085"
"1087","1086"
