":START_ID",":END_ID"
"3825","3834"
"3825","3833"
"3825","3836"
"3825","3835"
"3825","3832"
"3826","3828"
"3826","3829"
"3826","3830"
"3826","3827"
"3826","3831"
