":START_ID",":END_ID"
"1603","1609"
"1603","1610"
"1603","1611"
"1602","1612"
"1602","1613"
"1602","1614"
"1607","1616"
"1606","1617"
"1607","1618"
