":START_ID",":END_ID"
"1430","1388"
"1431","1388"
"1432","1389"
"1433","1389"
"1434","1390"
"1435","1389"
"1436","1391"
"1437","1392"
"1438","1392"
"1439","1393"
"1440","1393"
