":START_ID",":END_ID"
"1295","1172"
"1295","1173"
"1295","1174"
"1295","1175"
"1295","1176"
"1295","1177"
"1295","1178"
"1295","1179"
"1295","1180"
"1295","1181"
"1295","1182"
"1295","1183"
"1295","1184"
"1295","1185"
"1295","1186"
"1295","1187"
"1295","1188"
"1295","1189"
"1295","1190"
"1295","1191"
"1295","1192"
"1295","1193"
"1295","1194"
"1295","1195"
"1295","1196"
"1295","1197"
"1295","1198"
"1295","1199"
"1295","1200"
"1295","1201"
"1295","1202"
"1295","1203"
"1295","1204"
"1295","1205"
"1295","1206"
"1295","1207"
"1295","1208"
"1295","1209"
"1295","1210"
"1295","1211"
"1295","1212"
"1295","1213"
"1295","1214"
"1295","1215"
"1295","1216"
"1295","1217"
"1295","1218"
"1295","1219"
"1295","1220"
"1295","1221"
"1295","1222"
"1295","1223"
"1295","1224"
"1295","1225"
"1295","1226"
"1295","1227"
"1295","1228"
"1295","1229"
"1295","1230"
"1295","1231"
"1295","1232"
"1295","1233"
"1295","1234"
"1295","1235"
"1295","1236"
"1295","1237"
"1295","1238"
"1295","1239"
"1295","1240"
"1295","1241"
"1295","1242"
"1295","1243"
"1295","1244"
"1295","1245"
"1295","1246"
"1295","1247"
"1295","1248"
"1295","1249"
"1295","1250"
"1295","1251"
"1295","1252"
"1295","1253"
"1295","1254"
"1295","1255"
"1295","1256"
"1295","1257"
"1295","1258"
"1295","1259"
"1295","1260"
"1295","1261"
"1295","1262"
"1295","1263"
"1295","1264"
"1295","1265"
"1295","1266"
"1295","1267"
"1295","1268"
"1295","1269"
"1295","1270"
"1295","1271"
"1295","1272"
"1295","1273"
"1295","1274"
"1295","1275"
"1295","1276"
"1295","1277"
"1295","1278"
"1295","1279"
"1295","1280"
"1295","1281"
"1295","1282"
"1295","1283"
"1295","1284"
"1295","1285"
"1295","1286"
"1295","1287"
"1295","1288"
"1295","1289"
"1295","1290"
"1295","1291"
"1295","1292"
"1295","1293"
"1295","1294"
