":START_ID",":END_ID"
"1636","1640"
"1637","1641"
"1637","1642"
"1638","1643"
"1684","1648"
"1685","1649"
"1686","1650"
"1687","1651"
"1688","1652"
"1689","1653"
"1690","1654"
"1691","1655"
"1692","1656"
"1693","1657"
"1694","1658"
"1695","1659"
