":START_ID",":END_ID"
"1506","1680"
"1506","1681"
"1506","1682"
"1506","1683"
"1506","1684"
"1506","1685"
"1506","1687"
"1506","1688"
"1506","1689"
"1506","1690"
"1506","1691"
"1506","1693"
"1507","1686"
"1507","1692"
"1508","1680"
"1508","1681"
"1508","1682"
"1508","1683"
"1508","1684"
"1508","1685"
"1508","1687"
"1508","1688"
"1508","1689"
"1508","1690"
"1508","1691"
"1508","1693"
