":START_ID",":END_ID"
"1442","1616"
"1442","1617"
"1442","1618"
"1442","1619"
"1442","1620"
"1442","1621"
"1442","1623"
"1442","1624"
"1442","1625"
"1442","1626"
"1442","1627"
"1442","1629"
"1443","1622"
"1443","1628"
"1444","1616"
"1444","1617"
"1444","1618"
"1444","1619"
"1444","1620"
"1444","1621"
"1444","1623"
"1444","1624"
"1444","1625"
"1444","1626"
"1444","1627"
"1444","1629"
