":START_ID",":END_ID"
"1514","1543"
"1516","1544"
"1516","1546"
"1516","1546"
"1518","1547"
"1519","1548"
"1519","1549"
"1520","1539"
"1520","1540"
"1521","1537"
"1521","1538"
"1523","1550"
"1524","1551"
"1525","1541"
"1527","1542"
"1528","1552"
"1528","1553"
