":START_ID",":END_ID"
"1085","1075"
"1085","1076"
"1085","1077"
"1085","1078"
"1085","1079"
"1085","1080"
"1085","1081"
"1085","1082"
"1085","1083"
"1085","1084"
