":START_ID",":END_ID"
"3707","3716"
"3707","3715"
"3707","3718"
"3707","3717"
"3707","3714"
"3708","3710"
"3708","3711"
"3708","3712"
"3708","3709"
"3708","3713"
