":START_ID",":END_ID"
"1684","1671"
"1685","1671"
"1686","1671"
"1687","1671"
"1688","1671"
"1689","1671"
"1690","1673"
"1691","1682"
"1692","1671"
"1693","1671"
"1694","1672"
"1695","1673"
"1696","1674"
"1697","1682"
"1698","1671"
"1699","1674"
"1700","1682"
"1701","1671"
"1702","1674"
"1703","1682"
"1704","1671"
"1705","1672"
"1706","1673"
"1707","1674"
"1708","1675"
"1709","1678"
"1710","1680"
"1711","1682"
"1712","1671"
"1713","1674"
"1714","1682"
"1715","1671"
"1716","1674"
"1717","1675"
"1718","1678"
"1719","1680"
"1720","1672"
"1721","1675"
"1722","1678"
"1723","1680"
"1725","1675"
"1726","1678"
"1727","1682"
"1728","1671"
"1729","1672"
"1730","1673"
"1731","1674"
"1732","1675"
"1733","1676"
"1734","1677"
"1735","1678"
"1736","1679"
"1737","1680"
"1738","1681"
"1739","1682"
"1740","1671"
"1741","1671"
