":START_ID",":END_ID"
"1571","1590"
"1579","1591"
"1579","1592"
"1580","1591"
"1580","1592"
"1585","1594"
"1586","1595"
