":START_ID",":END_ID"
"1662","1670"
"1663","1671"
"1663","1672"
"1664","1673"
"1710","1686"
"1711","1687"
"1712","1688"
"1713","1689"
"1714","1690"
"1715","1691"
"1716","1692"
"1717","1693"
"1718","1694"
"1719","1695"
"1720","1696"
"1721","1697"
