":START_ID",":END_ID"
"1456","1592"
"1457","1592"
"1458","1592"
"1459","1592"
"1460","1592"
"1461","1592"
"1462","1592"
"1463","1592"
"1464","1592"
"1465","1592"
"1466","1592"
