":START_ID",":END_ID"
"1785","1814"
"1785","1825"
"1785","1826"
"1785","1827"
"1787","1815"
"1787","1817"
"1787","1817"
"1789","1818"
"1790","1819"
"1790","1820"
"1791","1810"
"1791","1811"
"1792","1808"
"1792","1809"
"1794","1821"
"1795","1822"
"1796","1812"
"1798","1813"
"1799","1823"
"1799","1824"
"1800","1828"
