":START_ID",":END_ID"
"1120","1098"
"1120","1099"
"1120","1100"
"1120","1101"
"1120","1102"
"1120","1103"
"1120","1104"
"1120","1105"
"1120","1106"
"1120","1107"
"1120","1108"
"1120","1109"
"1120","1110"
"1120","1111"
"1120","1112"
"1120","1113"
"1120","1114"
"1120","1115"
"1120","1116"
"1120","1117"
"1120","1118"
"1120","1119"
