":START_ID",":END_ID"
"1511","1510"
"1512","1511"
"1513","1512"
"1514","1513"
"1515","1514"
"1516","1515"
"1517","1516"
"1518","1517"
"1519","1518"
"1520","1519"
"1521","1520"
"1522","1521"
"1523","1522"
"1524","1523"
"1525","1524"
"1526","1525"
"1527","1526"
"1528","1527"
