":START_ID",":END_ID"
"1636","1655"
"1644","1656"
"1644","1657"
"1645","1656"
"1645","1657"
"1650","1659"
"1651","1660"
