":START_ID",":END_ID"
"1692","1750"
"1693","1751"
"1694","1752"
"1695","1753"
"1696","1754"
"1697","1755"
"1698","1755"
"1699","1755"
"1700","1756"
"1701","1757"
"1702","1757"
"1703","1757"
"1704","1757"
"1705","1757"
"1706","1758"
"1707","1758"
"1708","1758"
"1709","1759"
"1710","1759"
"1711","1759"
"1712","1760"
"1713","1760"
"1714","1760"
"1715","1760"
"1716","1760"
"1717","1760"
"1718","1760"
"1719","1760"
"1720","1761"
"1721","1761"
"1722","1761"
"1723","1762"
"1724","1762"
"1725","1763"
"1726","1763"
"1727","1763"
"1728","1764"
"1729","1764"
"1730","1764"
"1731","1764"
"1732","1765"
"1733","1765"
"1734","1765"
"1735","1765"
"1736","1766"
"1737","1766"
"1738","1766"
"1739","1766"
"1740","1766"
"1741","1766"
"1742","1766"
"1743","1766"
"1744","1766"
"1745","1766"
"1746","1766"
"1747","1766"
"1748","1767"
"1749","1769"
