":START_ID",":END_ID"
"1494","1500"
"1494","1501"
"1494","1502"
"1493","1503"
"1493","1504"
"1493","1505"
"1498","1507"
"1497","1508"
"1498","1509"
