":START_ID",":END_ID"
"1418","1424"
"1418","1425"
"1418","1426"
"1417","1427"
"1417","1428"
"1417","1429"
"1422","1431"
"1421","1432"
"1422","1433"
