":START_ID",":END_ID"
"1670","1657"
"1671","1657"
"1672","1657"
"1673","1657"
"1674","1657"
"1675","1657"
"1676","1659"
"1677","1668"
"1678","1657"
"1679","1657"
"1680","1658"
"1681","1659"
"1682","1660"
"1683","1668"
"1684","1657"
"1685","1660"
"1686","1668"
"1687","1657"
"1688","1660"
"1689","1668"
"1690","1657"
"1691","1658"
"1692","1659"
"1693","1660"
"1694","1661"
"1695","1664"
"1696","1666"
"1697","1668"
"1698","1657"
"1699","1660"
"1700","1668"
"1701","1657"
"1702","1660"
"1703","1661"
"1704","1664"
"1705","1666"
"1706","1658"
"1707","1661"
"1708","1664"
"1709","1666"
"1711","1661"
"1712","1664"
"1713","1668"
"1714","1657"
"1715","1658"
"1716","1659"
"1717","1660"
"1718","1661"
"1719","1662"
"1720","1663"
"1721","1664"
"1722","1665"
"1723","1666"
"1724","1667"
"1725","1668"
