":START_ID",":END_ID"
"1498","1672"
"1498","1673"
"1498","1674"
"1498","1675"
"1498","1676"
"1498","1677"
"1498","1679"
"1498","1680"
"1498","1681"
"1498","1682"
"1498","1683"
"1498","1685"
"1499","1678"
"1499","1684"
"1500","1672"
"1500","1673"
"1500","1674"
"1500","1675"
"1500","1676"
"1500","1677"
"1500","1679"
"1500","1680"
"1500","1681"
"1500","1682"
"1500","1683"
"1500","1685"
