":START_ID",":END_ID"
"1627","1646"
"1635","1647"
"1635","1648"
"1636","1647"
"1636","1648"
"1641","1650"
"1642","1651"
