":START_ID",":END_ID"
"1500","1519"
"1508","1520"
"1508","1521"
"1509","1520"
"1509","1521"
"1514","1523"
"1515","1524"
