":START_ID",":END_ID"
"1388","1441"
"1389","1442"
"1389","1443"
"1389","1444"
"1390","1445"
"1390","1446"
"1390","1447"
"1391","1448"
"1391","1449"
"1392","1450"
"1392","1451"
"1393","1452"
"1393","1453"
