":START_ID",":END_ID"
"1368","1432"
"1368","1433"
"1368","1434"
"1368","1435"
"1368","1436"
"1368","1437"
"1368","1438"
"1368","1439"
"1368","1440"
"1368","1441"
"1368","1442"
