":START_ID",":END_ID"
"1527","1531"
"1528","1532"
"1528","1533"
"1529","1534"
"1575","1539"
"1576","1540"
"1577","1541"
"1578","1542"
"1579","1543"
"1580","1544"
"1581","1545"
"1582","1546"
"1583","1547"
"1584","1548"
"1585","1549"
"1586","1550"
