":START_ID",":END_ID"
"1178","1138"
"1178","1139"
"1178","1140"
"1178","1141"
"1178","1142"
"1178","1143"
"1178","1144"
"1178","1145"
"1178","1146"
"1178","1147"
"1178","1148"
"1178","1149"
"1178","1150"
"1178","1151"
"1178","1152"
"1178","1153"
"1178","1154"
"1178","1155"
"1178","1156"
"1178","1157"
"1178","1158"
"1178","1159"
"1178","1160"
"1178","1161"
"1178","1162"
"1178","1163"
"1178","1164"
"1178","1165"
"1178","1166"
"1178","1167"
"1178","1168"
"1178","1169"
"1178","1170"
"1178","1171"
"1178","1172"
"1178","1173"
"1178","1174"
"1178","1175"
"1178","1176"
"1178","1177"
