":START_ID",":END_ID"
"1466","1453"
"1467","1453"
"1468","1453"
"1469","1453"
"1470","1453"
"1471","1453"
"1472","1455"
"1473","1464"
"1474","1453"
"1475","1453"
"1476","1454"
"1477","1455"
"1478","1456"
"1479","1464"
"1480","1453"
"1481","1456"
"1482","1464"
"1483","1453"
"1484","1456"
"1485","1464"
"1486","1453"
"1487","1454"
"1488","1455"
"1489","1456"
"1490","1457"
"1491","1460"
"1492","1462"
"1493","1464"
"1494","1453"
"1495","1456"
"1496","1464"
"1497","1453"
"1498","1456"
"1499","1457"
"1500","1460"
"1501","1462"
"1502","1454"
"1503","1457"
"1504","1460"
"1505","1462"
"1507","1457"
"1508","1460"
"1509","1464"
"1510","1453"
"1511","1454"
"1512","1455"
"1513","1456"
"1514","1457"
"1515","1458"
"1516","1459"
"1517","1460"
"1518","1461"
"1519","1462"
"1520","1463"
"1521","1464"
