":START_ID",":END_ID"
"1701","1659"
"1702","1659"
"1703","1660"
"1704","1660"
"1705","1661"
"1706","1660"
"1707","1662"
"1708","1663"
"1709","1663"
"1710","1664"
"1711","1664"
