":START_ID",":END_ID"
"1618","1671"
"1619","1672"
"1619","1673"
"1619","1674"
"1620","1675"
"1620","1676"
"1620","1677"
"1621","1678"
"1621","1679"
"1622","1680"
"1622","1681"
"1623","1682"
"1623","1683"
