":START_ID",":END_ID"
"1306","1183"
"1306","1184"
"1306","1185"
"1306","1186"
"1306","1187"
"1306","1188"
"1306","1189"
"1306","1190"
"1306","1191"
"1306","1192"
"1306","1193"
"1306","1194"
"1306","1195"
"1306","1196"
"1306","1197"
"1306","1198"
"1306","1199"
"1306","1200"
"1306","1201"
"1306","1202"
"1306","1203"
"1306","1204"
"1306","1205"
"1306","1206"
"1306","1207"
"1306","1208"
"1306","1209"
"1306","1210"
"1306","1211"
"1306","1212"
"1306","1213"
"1306","1214"
"1306","1215"
"1306","1216"
"1306","1217"
"1306","1218"
"1306","1219"
"1306","1220"
"1306","1221"
"1306","1222"
"1306","1223"
"1306","1224"
"1306","1225"
"1306","1226"
"1306","1227"
"1306","1228"
"1306","1229"
"1306","1230"
"1306","1231"
"1306","1232"
"1306","1233"
"1306","1234"
"1306","1235"
"1306","1236"
"1306","1237"
"1306","1238"
"1306","1239"
"1306","1240"
"1306","1241"
"1306","1242"
"1306","1243"
"1306","1244"
"1306","1245"
"1306","1246"
"1306","1247"
"1306","1248"
"1306","1249"
"1306","1250"
"1306","1251"
"1306","1252"
"1306","1253"
"1306","1254"
"1306","1255"
"1306","1256"
"1306","1257"
"1306","1258"
"1306","1259"
"1306","1260"
"1306","1261"
"1306","1262"
"1306","1263"
"1306","1264"
"1306","1265"
"1306","1266"
"1306","1267"
"1306","1268"
"1306","1269"
"1306","1270"
"1306","1271"
"1306","1272"
"1306","1273"
"1306","1274"
"1306","1275"
"1306","1276"
"1306","1277"
"1306","1278"
"1306","1279"
"1306","1280"
"1306","1281"
"1306","1282"
"1306","1283"
"1306","1284"
"1306","1285"
"1306","1286"
"1306","1287"
"1306","1288"
"1306","1289"
"1306","1290"
"1306","1291"
"1306","1292"
"1306","1293"
"1306","1294"
"1306","1295"
"1306","1296"
"1306","1297"
"1306","1298"
"1306","1299"
"1306","1300"
"1306","1301"
"1306","1302"
"1306","1303"
"1306","1304"
"1306","1305"
