":START_ID",":END_ID"
"1750","1780"
"1750","1791"
"1750","1792"
"1750","1793"
"1752","1781"
"1752","1783"
"1752","1783"
"1754","1784"
"1755","1785"
"1755","1786"
"1756","1776"
"1756","1777"
"1757","1774"
"1757","1775"
"1759","1787"
"1760","1788"
"1761","1778"
"1763","1779"
"1764","1789"
"1764","1790"
"1765","1794"
"1767","1795"
