":START_ID",":END_ID"
"1468","1432"
"1469","1433"
"1474","1434"
"1475","1435"
"1476","1436"
"1481","1437"
"1482","1438"
"1483","1439"
"1488","1440"
"1489","1441"
"1490","1442"
"1495","1443"
"1496","1444"
"1497","1445"
"1502","1446"
"1503","1447"
"1504","1448"
"1509","1449"
"1510","1450"
"1511","1451"
"1516","1452"
"1517","1453"
"1518","1454"
"1523","1455"
"1524","1456"
"1525","1457"
"1530","1458"
