":START_ID",":END_ID"
"1396","1404"
"1397","1405"
"1397","1406"
"1398","1407"
"1444","1420"
"1445","1421"
"1446","1422"
"1447","1423"
"1448","1424"
"1449","1425"
"1450","1426"
"1451","1427"
"1452","1428"
"1453","1429"
"1454","1430"
"1455","1431"
