":START_ID",":END_ID"
"24","17"
"25","18"
"26","19"
"27","20"
"48","21"
