":START_ID",":END_ID"
"1660","1624"
"1661","1624"
"1662","1625"
"1663","1626"
"1664","1625"
"1665","1626"
"1666","1625"
"1667","1625"
"1668","1626"
"1669","1627"
"1670","1627"
