":START_ID",":END_ID"
"1581","1587"
"1581","1588"
"1581","1589"
"1580","1590"
"1580","1591"
"1580","1592"
"1585","1594"
"1584","1595"
"1585","1596"
