":START_ID",":END_ID"
"1362","1371"
"1362","1372"
"1362","1373"
"1362","1374"
"1362","1375"
"1362","1376"
"1362","1377"
"1363","1378"
"1363","1379"
"1363","1380"
"1363","1381"
"1363","1382"
"1363","1383"
"1363","1384"
"1364","1385"
"1364","1386"
"1364","1387"
"1364","1388"
"1364","1389"
"1364","1390"
"1364","1391"
"1365","1392"
"1365","1393"
"1365","1394"
"1365","1395"
"1365","1396"
"1365","1397"
"1365","1398"
"1366","1399"
"1366","1400"
"1366","1401"
"1366","1402"
"1366","1403"
"1366","1404"
"1366","1405"
"1367","1406"
"1367","1412"
"1367","1408"
"1367","1409"
"1367","1410"
"1367","1411"
"1367","1412"
"1367","1413"
"1368","1414"
"1368","1420"
"1368","1416"
"1368","1417"
"1368","1418"
"1368","1419"
"1368","1420"
"1368","1421"
"1369","1422"
"1369","1428"
"1369","1424"
"1369","1425"
"1369","1426"
"1369","1427"
"1369","1428"
"1369","1429"
"1370","1430"
"1370","1436"
"1370","1432"
"1370","1433"
"1370","1434"
"1370","1435"
"1370","1436"
"1370","1437"
