":START_ID",":END_ID"
"1175","1135"
"1175","1136"
"1175","1137"
"1175","1138"
"1175","1139"
"1175","1140"
"1175","1141"
"1175","1142"
"1175","1143"
"1175","1144"
"1175","1145"
"1175","1146"
"1175","1147"
"1175","1148"
"1175","1149"
"1175","1150"
"1175","1151"
"1175","1152"
"1175","1153"
"1175","1154"
"1175","1155"
"1175","1156"
"1175","1157"
"1175","1158"
"1175","1159"
"1175","1160"
"1175","1161"
"1175","1162"
"1175","1163"
"1175","1164"
"1175","1165"
"1175","1166"
"1175","1167"
"1175","1168"
"1175","1169"
"1175","1170"
"1175","1171"
"1175","1172"
"1175","1173"
"1175","1174"
