":START_ID",":END_ID"
"1346","1303"
"1347","1304"
"1348","1305"
"1349","1306"
"1350","1307"
"1351","1308"
"1352","1309"
"1352","1310"
"1353","1311"
"1354","1312"
"1355","1313"
"1356","1314"
"1357","1315"
"1358","1316"
"1359","1317"
"1360","1318"
"1360","1319"
"1361","1320"
"1362","1321"
"1363","1322"
"1364","1323"
"1365","1324"
"1366","1325"
"1367","1326"
"1368","1327"
"1369","1328"
"1370","1329"
"1371","1330"
"1372","1331"
"1373","1332"
"1374","1333"
"1375","1334"
"1376","1335"
"1377","1336"
"1378","1337"
"1379","1338"
"1380","1339"
"1381","1340"
"1382","1341"
"1383","1342"
"1384","1343"
"1385","1344"
"1386","1345"
