":START_ID",":END_ID"
"1444","1500"
"1445","1501"
"1446","1502"
"1447","1503"
"1448","1504"
"1449","1505"
"1450","1505"
"1451","1505"
"1452","1506"
"1453","1507"
"1454","1507"
"1455","1507"
"1456","1507"
"1457","1507"
"1458","1508"
"1459","1508"
"1460","1508"
"1461","1509"
"1462","1509"
"1463","1509"
"1464","1510"
"1465","1510"
"1466","1510"
"1467","1510"
"1468","1510"
"1469","1510"
"1470","1510"
"1471","1510"
"1472","1511"
"1473","1511"
"1474","1511"
"1475","1512"
"1476","1512"
"1477","1513"
"1478","1513"
"1479","1513"
"1480","1514"
"1481","1514"
"1482","1514"
"1483","1514"
"1484","1515"
"1485","1515"
"1486","1515"
"1487","1515"
"1488","1516"
"1489","1516"
"1490","1516"
"1491","1516"
"1492","1516"
"1493","1516"
"1494","1516"
"1495","1516"
"1496","1516"
"1497","1516"
"1498","1516"
"1499","1516"
