":START_ID",":END_ID"
"1389","1348"
"1389","1349"
"1389","1350"
"1389","1351"
"1389","1352"
"1389","1353"
"1389","1354"
"1390","1355"
"1390","1356"
"1390","1357"
"1390","1358"
"1390","1359"
"1390","1360"
"1390","1361"
"1390","1362"
"1390","1363"
"1391","1364"
"1391","1365"
"1391","1366"
"1391","1367"
"1391","1368"
"1391","1369"
"1391","1370"
"1391","1371"
"1391","1372"
"1391","1373"
"1391","1374"
"1391","1375"
"1391","1376"
"1391","1377"
"1391","1378"
"1391","1379"
"1391","1380"
"1391","1381"
"1391","1382"
"1391","1383"
"1391","1384"
"1391","1385"
"1391","1386"
"1392","1387"
"1392","1388"
