":START_ID",":END_ID"
"1355","1335"
"1356","1336"
"1361","1337"
"1362","1338"
"1363","1339"
"1368","1340"
"1369","1341"
"1370","1342"
"1375","1343"
"1376","1344"
"1377","1345"
"1382","1346"
"1383","1347"
"1384","1348"
"1389","1349"
