":START_ID",":END_ID"
"1759","1696"
"1759","1697"
"1759","1698"
"1759","1699"
"1759","1700"
"1759","1701"
"1759","1702"
"1759","1703"
"1759","1704"
"1759","1705"
"1759","1706"
"1759","1707"
"1759","1708"
"1759","1709"
"1759","1710"
"1759","1711"
"1759","1712"
"1759","1713"
"1759","1714"
"1759","1715"
"1759","1716"
"1759","1717"
"1759","1718"
"1759","1719"
"1759","1720"
"1759","1721"
"1759","1722"
"1759","1723"
"1759","1724"
"1759","1725"
"1759","1726"
"1759","1727"
"1759","1728"
"1759","1729"
"1759","1730"
"1759","1731"
"1759","1732"
"1759","1733"
"1759","1734"
"1759","1735"
"1759","1736"
"1759","1737"
"1759","1738"
"1759","1739"
"1759","1740"
"1759","1741"
"1759","1742"
"1759","1743"
"1759","1744"
"1759","1745"
"1759","1746"
"1759","1747"
"1759","1748"
"1759","1749"
"1759","1750"
"1759","1751"
"1759","1752"
"1759","1753"
"1759","1754"
"1759","1755"
"1759","1756"
"1759","1757"
"1759","1758"
