":START_ID",":END_ID"
"1442","1406"
"1443","1406"
"1444","1407"
"1445","1408"
"1446","1407"
"1447","1408"
"1448","1407"
"1449","1407"
"1450","1408"
"1451","1409"
"1452","1409"
