":START_ID",":END_ID"
"1596","1660"
"1596","1661"
"1596","1662"
"1596","1663"
"1596","1664"
"1596","1665"
"1596","1666"
"1596","1667"
"1596","1668"
"1596","1669"
"1596","1670"
