":START_ID",":END_ID"
"3835","3836"
"3835","3837"
"3835","3838"
"3835","3839"
"3835","3840"
"3835","3841"
