":START_ID",":END_ID"
"3851","3852"
"3851","3853"
"3851","3854"
"3851","3855"
"3851","3856"
