":START_ID",":END_ID"
"3842","3825"
"3843","3826"
"3844","3827"
"3845","3828"
"3846","3829"
"3847","3830"
"3848","3831"
"3849","3832"
"3850","3833"
"3850","3834"
"3851","3835"
"3852","3836"
