":START_ID",":END_ID"
"1435","1581"
"1437","1582"
"1437","1583"
"1438","1584"
"1440","1585"
"1440","1586"
"1440","1587"
"1440","1588"
"1440","1589"
"1440","1590"
"1440","1591"
"1441","1592"
"1443","1593"
"1443","1594"
"1443","1595"
"1443","1596"
"1444","1597"
"1446","1598"
"1446","1599"
"1446","1600"
"1446","1601"
"1446","1602"
"1447","1603"
"1449","1604"
"1449","1605"
"1449","1606"
"1449","1607"
"1450","1608"
"1451","1609"
"1451","1610"
"1451","1611"
"1452","1612"
"1452","1613"
"1453","1614"
"1454","1615"
"1455","1616"
"1455","1617"
"1456","1618"
"1457","1619"
"1458","1620"
"1458","1621"
"1459","1622"
"1460","1623"
"1461","1624"
"1461","1625"
"1462","1626"
