":START_ID",":END_ID"
"1455","1572"
"1456","1572"
"1457","1572"
"1458","1572"
"1459","1572"
"1460","1572"
"1461","1572"
"1462","1572"
"1463","1572"
