":START_ID",":END_ID"
"1665","1669"
"1666","1670"
"1666","1671"
"1667","1672"
"1713","1677"
"1714","1678"
"1715","1679"
"1716","1680"
"1717","1681"
"1718","1682"
"1719","1683"
"1720","1684"
"1721","1685"
"1722","1686"
"1723","1687"
"1724","1688"
