":START_ID",":END_ID"
"1090","1080"
"1090","1081"
"1090","1082"
"1090","1083"
"1090","1084"
"1090","1085"
"1090","1086"
"1090","1087"
"1090","1088"
"1090","1089"
