":START_ID",":END_ID"
"1307","1184"
"1307","1185"
"1307","1186"
"1307","1187"
"1307","1188"
"1307","1189"
"1307","1190"
"1307","1191"
"1307","1192"
"1307","1193"
"1307","1194"
"1307","1195"
"1307","1196"
"1307","1197"
"1307","1198"
"1307","1199"
"1307","1200"
"1307","1201"
"1307","1202"
"1307","1203"
"1307","1204"
"1307","1205"
"1307","1206"
"1307","1207"
"1307","1208"
"1307","1209"
"1307","1210"
"1307","1211"
"1307","1212"
"1307","1213"
"1307","1214"
"1307","1215"
"1307","1216"
"1307","1217"
"1307","1218"
"1307","1219"
"1307","1220"
"1307","1221"
"1307","1222"
"1307","1223"
"1307","1224"
"1307","1225"
"1307","1226"
"1307","1227"
"1307","1228"
"1307","1229"
"1307","1230"
"1307","1231"
"1307","1232"
"1307","1233"
"1307","1234"
"1307","1235"
"1307","1236"
"1307","1237"
"1307","1238"
"1307","1239"
"1307","1240"
"1307","1241"
"1307","1242"
"1307","1243"
"1307","1244"
"1307","1245"
"1307","1246"
"1307","1247"
"1307","1248"
"1307","1249"
"1307","1250"
"1307","1251"
"1307","1252"
"1307","1253"
"1307","1254"
"1307","1255"
"1307","1256"
"1307","1257"
"1307","1258"
"1307","1259"
"1307","1260"
"1307","1261"
"1307","1262"
"1307","1263"
"1307","1264"
"1307","1265"
"1307","1266"
"1307","1267"
"1307","1268"
"1307","1269"
"1307","1270"
"1307","1271"
"1307","1272"
"1307","1273"
"1307","1274"
"1307","1275"
"1307","1276"
"1307","1277"
"1307","1278"
"1307","1279"
"1307","1280"
"1307","1281"
"1307","1282"
"1307","1283"
"1307","1284"
"1307","1285"
"1307","1286"
"1307","1287"
"1307","1288"
"1307","1289"
"1307","1290"
"1307","1291"
"1307","1292"
"1307","1293"
"1307","1294"
"1307","1295"
"1307","1296"
"1307","1297"
"1307","1298"
"1307","1299"
"1307","1300"
"1307","1301"
"1307","1302"
"1307","1303"
"1307","1304"
"1307","1305"
"1307","1306"
