":START_ID",":END_ID"
"1744","1774"
"1744","1785"
"1744","1786"
"1744","1787"
"1746","1775"
"1746","1777"
"1746","1777"
"1748","1778"
"1749","1779"
"1749","1780"
"1750","1770"
"1750","1771"
"1751","1768"
"1751","1769"
"1753","1781"
"1754","1782"
"1755","1772"
"1757","1773"
"1758","1783"
"1758","1784"
"1759","1788"
