":START_ID",":END_ID"
"1454","1441"
"1455","1441"
"1456","1441"
"1457","1441"
"1458","1441"
"1459","1441"
"1460","1443"
"1461","1452"
"1462","1441"
"1463","1441"
"1464","1442"
"1465","1443"
"1466","1444"
"1467","1452"
"1468","1441"
"1469","1444"
"1470","1452"
"1471","1441"
"1472","1444"
"1473","1452"
"1474","1441"
"1475","1442"
"1476","1443"
"1477","1444"
"1478","1445"
"1479","1448"
"1480","1450"
"1481","1452"
"1482","1441"
"1483","1444"
"1484","1452"
"1485","1441"
"1486","1444"
"1487","1445"
"1488","1448"
"1489","1450"
"1490","1442"
"1491","1445"
"1492","1448"
"1493","1450"
"1495","1445"
"1496","1448"
"1497","1452"
"1498","1441"
"1499","1442"
"1500","1443"
"1501","1444"
"1502","1445"
"1503","1446"
"1504","1447"
"1505","1448"
"1506","1449"
"1507","1450"
"1508","1451"
"1509","1452"
