":START_ID",":END_ID"
"1358","1473"
"1359","1473"
"1360","1473"
"1361","1473"
"1362","1473"
"1363","1473"
"1364","1473"
"1365","1473"
"1366","1473"
