":START_ID",":END_ID"
"1447","1503"
"1448","1504"
"1449","1505"
"1450","1506"
"1451","1507"
"1452","1508"
"1453","1508"
"1454","1508"
"1455","1509"
"1456","1510"
"1457","1510"
"1458","1510"
"1459","1510"
"1460","1510"
"1461","1511"
"1462","1511"
"1463","1511"
"1464","1512"
"1465","1512"
"1466","1512"
"1467","1513"
"1468","1513"
"1469","1513"
"1470","1513"
"1471","1513"
"1472","1513"
"1473","1513"
"1474","1513"
"1475","1514"
"1476","1514"
"1477","1514"
"1478","1515"
"1479","1515"
"1480","1516"
"1481","1516"
"1482","1516"
"1483","1517"
"1484","1517"
"1485","1517"
"1486","1517"
"1487","1518"
"1488","1518"
"1489","1518"
"1490","1518"
"1491","1519"
"1492","1519"
"1493","1519"
"1494","1519"
"1495","1519"
"1496","1519"
"1497","1519"
"1498","1519"
"1499","1519"
"1500","1519"
"1501","1519"
"1502","1519"
