":START_ID",":END_ID"
"1698","1652"
"1699","1653"
"1700","1652"
"1701","1653"
"1702","1652"
"1703","1653"
"1704","1652"
"1705","1652"
"1706","1653"
"1707","1652"
"1708","1653"
