":START_ID",":END_ID"
"1447","1455"
"1448","1456"
"1448","1457"
"1449","1458"
"1495","1471"
"1496","1472"
"1497","1473"
"1498","1474"
"1499","1475"
"1500","1476"
"1501","1477"
"1502","1478"
"1503","1479"
"1504","1480"
"1505","1481"
"1506","1482"
