":START_ID",":END_ID"
"1547","1511"
"1548","1511"
"1549","1512"
"1550","1513"
"1551","1512"
"1552","1513"
"1553","1512"
"1554","1512"
"1555","1513"
"1556","1514"
"1557","1514"
