":START_ID",":END_ID"
"1722","1709"
"1723","1709"
"1724","1709"
"1725","1709"
"1726","1709"
"1727","1709"
"1728","1711"
"1729","1720"
"1730","1709"
"1731","1709"
"1732","1710"
"1733","1711"
"1734","1712"
"1735","1720"
"1736","1709"
"1737","1712"
"1738","1720"
"1739","1709"
"1740","1712"
"1741","1720"
"1742","1709"
"1743","1710"
"1744","1711"
"1745","1712"
"1746","1713"
"1747","1716"
"1748","1718"
"1749","1720"
"1750","1709"
"1751","1712"
"1752","1720"
"1753","1709"
"1754","1712"
"1755","1713"
"1756","1716"
"1757","1718"
"1758","1710"
"1759","1713"
"1760","1716"
"1761","1718"
"1763","1713"
"1764","1716"
"1765","1720"
"1766","1709"
"1767","1710"
"1768","1711"
"1769","1712"
"1770","1713"
"1771","1714"
"1772","1715"
"1773","1716"
"1774","1717"
"1775","1718"
"1776","1719"
"1777","1720"
