":START_ID",":END_ID"
"1109","1087"
"1109","1088"
"1109","1089"
"1109","1090"
"1109","1091"
"1109","1092"
"1109","1093"
"1109","1094"
"1109","1095"
"1109","1096"
"1109","1097"
"1109","1098"
"1109","1099"
"1109","1100"
"1109","1101"
"1109","1102"
"1109","1103"
"1109","1104"
"1109","1105"
"1109","1106"
"1109","1107"
"1109","1108"
