":START_ID",":END_ID"
"1381","1434"
"1382","1435"
"1382","1436"
"1382","1437"
"1383","1438"
"1383","1439"
"1383","1440"
"1384","1441"
"1384","1442"
"1385","1443"
"1385","1444"
"1386","1445"
"1386","1446"
