":START_ID",":END_ID"
"1346","1409"
"1347","1409"
"1348","1409"
"1349","1409"
"1350","1409"
