":START_ID",":END_ID"
"1362","1485"
"1363","1485"
"1364","1485"
"1365","1485"
"1366","1485"
"1367","1485"
"1368","1485"
"1369","1485"
"1370","1485"
