":START_ID",":END_ID"
"1456","1443"
"1457","1443"
"1458","1443"
"1459","1443"
"1460","1443"
"1461","1443"
"1462","1445"
"1463","1454"
"1464","1443"
"1465","1443"
"1466","1444"
"1467","1445"
"1468","1446"
"1469","1454"
"1470","1443"
"1471","1446"
"1472","1454"
"1473","1443"
"1474","1446"
"1475","1454"
"1476","1443"
"1477","1444"
"1478","1445"
"1479","1446"
"1480","1447"
"1481","1450"
"1482","1452"
"1483","1454"
"1484","1443"
"1485","1446"
"1486","1454"
"1487","1443"
"1488","1446"
"1489","1447"
"1490","1450"
"1491","1452"
"1492","1444"
"1493","1447"
"1494","1450"
"1495","1452"
"1497","1447"
"1498","1450"
"1499","1454"
"1500","1443"
"1501","1444"
"1502","1445"
"1503","1446"
"1504","1447"
"1505","1448"
"1506","1449"
"1507","1450"
"1508","1451"
"1509","1452"
"1510","1453"
"1511","1454"
