":START_ID",":END_ID"
"1604","1657"
"1605","1658"
"1605","1659"
"1605","1660"
"1606","1661"
"1606","1662"
"1606","1663"
"1607","1664"
"1607","1665"
"1608","1666"
"1608","1667"
"1609","1668"
"1609","1669"
