":START_ID",":END_ID"
"1491","1497"
"1491","1498"
"1491","1499"
"1490","1500"
"1490","1501"
"1490","1502"
"1495","1504"
"1494","1505"
"1495","1506"
