":START_ID",":END_ID"
"1378","1442"
"1378","1443"
"1378","1444"
"1378","1445"
"1378","1446"
"1378","1447"
"1378","1448"
"1378","1449"
"1378","1450"
"1378","1451"
"1378","1452"
