":START_ID",":END_ID"
"1571","1558"
"1572","1558"
"1573","1558"
"1574","1558"
"1575","1558"
"1576","1558"
"1577","1560"
"1578","1569"
"1579","1558"
"1580","1558"
"1581","1559"
"1582","1560"
"1583","1561"
"1584","1569"
"1585","1558"
"1586","1561"
"1587","1569"
"1588","1558"
"1589","1561"
"1590","1569"
"1591","1558"
"1592","1559"
"1593","1560"
"1594","1561"
"1595","1562"
"1596","1565"
"1597","1567"
"1598","1569"
"1599","1558"
"1600","1561"
"1601","1569"
"1602","1558"
"1603","1561"
"1604","1562"
"1605","1565"
"1606","1567"
"1607","1559"
"1608","1562"
"1609","1565"
"1610","1567"
"1612","1562"
"1613","1565"
"1614","1569"
"1615","1558"
"1616","1559"
"1617","1560"
"1618","1561"
"1619","1562"
"1620","1563"
"1621","1564"
"1622","1565"
"1623","1566"
"1624","1567"
"1625","1568"
"1626","1569"
