":START_ID",":END_ID"
"1365","1301"
"1366","1302"
"1367","1303"
"1368","1304"
"1369","1305"
"1370","1306"
"1371","1307"
"1371","1308"
"1372","1309"
"1373","1310"
"1374","1311"
"1375","1312"
"1376","1313"
"1377","1314"
"1378","1315"
"1379","1316"
"1379","1317"
"1380","1318"
"1381","1319"
"1382","1320"
"1383","1321"
"1384","1322"
"1385","1323"
"1386","1324"
"1387","1325"
"1388","1326"
"1389","1327"
"1390","1328"
"1391","1329"
"1392","1330"
"1393","1331"
"1394","1332"
"1395","1333"
"1396","1334"
"1397","1335"
"1398","1336"
"1399","1337"
"1400","1338"
"1401","1339"
"1402","1340"
"1403","1341"
"1404","1342"
"1405","1343"
"1406","1344"
"1407","1345"
"1408","1346"
"1409","1347"
"1410","1348"
"1411","1349"
"1412","1350"
"1413","1351"
"1414","1352"
"1415","1353"
"1416","1354"
"1417","1355"
"1418","1356"
"1419","1357"
"1420","1358"
"1421","1359"
"1422","1360"
"1423","1361"
"1424","1362"
"1425","1363"
"1426","1364"
