":START_ID",":END_ID"
"1632","1636"
"1633","1637"
"1633","1638"
"1634","1639"
"1680","1644"
"1681","1645"
"1682","1646"
"1683","1647"
"1684","1648"
"1685","1649"
"1686","1650"
"1687","1651"
"1688","1652"
"1689","1653"
"1690","1654"
"1691","1655"
