":START_ID",":END_ID"
"1371","1542"
"1371","1543"
"1371","1544"
"1371","1545"
"1371","1546"
"1371","1547"
"1371","1549"
"1371","1550"
"1371","1551"
"1371","1552"
"1371","1553"
"1371","1555"
"1372","1548"
"1372","1554"
"1373","1542"
"1373","1543"
"1373","1544"
"1373","1545"
"1373","1546"
"1373","1547"
"1373","1549"
"1373","1550"
"1373","1551"
"1373","1552"
"1373","1553"
"1373","1555"
