":START_ID",":END_ID"
"1514","1567"
"1515","1568"
"1515","1569"
"1515","1570"
"1516","1571"
"1516","1572"
"1516","1573"
"1517","1574"
"1517","1575"
"1518","1576"
"1518","1577"
"1519","1578"
"1519","1579"
