":START_ID",":END_ID"
"1334","1318"
"1334","1319"
"1334","1320"
"1334","1321"
"1334","1322"
"1334","1323"
"1334","1324"
"1335","1325"
"1335","1326"
"1335","1327"
"1335","1328"
"1335","1329"
"1335","1330"
"1335","1331"
"1335","1332"
"1335","1333"
