":START_ID",":END_ID"
"1614","1618"
"1615","1619"
"1615","1620"
"1616","1621"
"1662","1626"
"1663","1627"
"1664","1628"
"1665","1629"
"1666","1630"
"1667","1631"
"1668","1632"
"1669","1633"
"1670","1634"
"1671","1635"
"1672","1636"
"1673","1637"
