":START_ID",":END_ID"
"3844","3853"
"3844","3852"
"3844","3855"
"3844","3854"
"3844","3851"
"3845","3847"
"3845","3848"
"3845","3849"
"3845","3846"
"3845","3850"
