":START_ID",":END_ID"
"1362","1489"
"1363","1489"
"1364","1489"
"1365","1489"
"1366","1489"
"1367","1489"
"1368","1489"
"1369","1489"
"1370","1489"
