":START_ID",":END_ID"
"1874","1811"
"1874","1812"
"1874","1813"
"1874","1814"
"1874","1815"
"1874","1816"
"1874","1817"
"1874","1818"
"1874","1819"
"1874","1820"
"1874","1821"
"1874","1822"
"1874","1823"
"1874","1824"
"1874","1825"
"1874","1826"
"1874","1827"
"1874","1828"
"1874","1829"
"1874","1830"
"1874","1831"
"1874","1832"
"1874","1833"
"1874","1834"
"1874","1835"
"1874","1836"
"1874","1837"
"1874","1838"
"1874","1839"
"1874","1840"
"1874","1841"
"1874","1842"
"1874","1843"
"1874","1844"
"1874","1845"
"1874","1846"
"1874","1847"
"1874","1848"
"1874","1849"
"1874","1850"
"1874","1851"
"1874","1852"
"1874","1853"
"1874","1854"
"1874","1855"
"1874","1856"
"1874","1857"
"1874","1858"
"1874","1859"
"1874","1860"
"1874","1861"
"1874","1862"
"1874","1863"
"1874","1864"
"1874","1865"
"1874","1866"
"1874","1867"
"1874","1868"
"1874","1869"
"1874","1870"
"1874","1871"
"1874","1872"
"1874","1873"
