":START_ID",":END_ID"
"1512","1531"
"1520","1532"
"1520","1533"
"1521","1532"
"1521","1533"
"1526","1535"
"1527","1536"
