":START_ID",":END_ID"
"28","29"
"28","30"
"28","31"
"33","34"
"33","35"
"33","28"
"33","36"
"33","37"
"37","38"
"37","39"
"37","40"
"33","41"
"41","42"
"33","43"
"43","44"
"43","45"
"43","46"
"43","40"
"33","47"
"33","48"
"49","50"
"49","51"
"49","52"
"49","53"
"49","54"
"49","36"
"49","55"
"49","56"
"49","28"
"49","57"
"49","58"
"49","59"
"49","60"
"49","61"
"49","62"
"62","63"
"62","64"
"62","65"
"49","32"
"49","41"
"41","42"
"49","66"
"66","67"
"66","68"
"49","69"
"49","70"
"70","71"
"70","72"
"70","73"
"70","74"
"70","75"
"70","76"
"77","78"
"77","32"
"77","60"
"77","55"
"77","48"
"77","79"
"77","80"
"77","81"
"77","82"
"82","83"
"82","84"
"77","85"
"77","86"
"77","87"
"77","88"
"88","89"
"88","90"
"88","91"
"77","28"
