":START_ID",":END_ID"
"1668","1632"
"1669","1632"
"1670","1633"
"1671","1634"
"1672","1633"
"1673","1634"
"1674","1633"
"1675","1633"
"1676","1634"
"1677","1635"
"1678","1635"
