":START_ID",":END_ID"
"1456","1467"
"1457","1474"
"1458","1477"
"1459","1480"
"1460","1487"
"1461","1490"
"1462","1497"
"1463","1504"
"1464","1511"
"1465","1518"
"1466","1541"
