":START_ID",":END_ID"
"1312","1189"
"1312","1190"
"1312","1191"
"1312","1192"
"1312","1193"
"1312","1194"
"1312","1195"
"1312","1196"
"1312","1197"
"1312","1198"
"1312","1199"
"1312","1200"
"1312","1201"
"1312","1202"
"1312","1203"
"1312","1204"
"1312","1205"
"1312","1206"
"1312","1207"
"1312","1208"
"1312","1209"
"1312","1210"
"1312","1211"
"1312","1212"
"1312","1213"
"1312","1214"
"1312","1215"
"1312","1216"
"1312","1217"
"1312","1218"
"1312","1219"
"1312","1220"
"1312","1221"
"1312","1222"
"1312","1223"
"1312","1224"
"1312","1225"
"1312","1226"
"1312","1227"
"1312","1228"
"1312","1229"
"1312","1230"
"1312","1231"
"1312","1232"
"1312","1233"
"1312","1234"
"1312","1235"
"1312","1236"
"1312","1237"
"1312","1238"
"1312","1239"
"1312","1240"
"1312","1241"
"1312","1242"
"1312","1243"
"1312","1244"
"1312","1245"
"1312","1246"
"1312","1247"
"1312","1248"
"1312","1249"
"1312","1250"
"1312","1251"
"1312","1252"
"1312","1253"
"1312","1254"
"1312","1255"
"1312","1256"
"1312","1257"
"1312","1258"
"1312","1259"
"1312","1260"
"1312","1261"
"1312","1262"
"1312","1263"
"1312","1264"
"1312","1265"
"1312","1266"
"1312","1267"
"1312","1268"
"1312","1269"
"1312","1270"
"1312","1271"
"1312","1272"
"1312","1273"
"1312","1274"
"1312","1275"
"1312","1276"
"1312","1277"
"1312","1278"
"1312","1279"
"1312","1280"
"1312","1281"
"1312","1282"
"1312","1283"
"1312","1284"
"1312","1285"
"1312","1286"
"1312","1287"
"1312","1288"
"1312","1289"
"1312","1290"
"1312","1291"
"1312","1292"
"1312","1293"
"1312","1294"
"1312","1295"
"1312","1296"
"1312","1297"
"1312","1298"
"1312","1299"
"1312","1300"
"1312","1301"
"1312","1302"
"1312","1303"
"1312","1304"
"1312","1305"
"1312","1306"
"1312","1307"
"1312","1308"
"1312","1309"
"1312","1310"
"1312","1311"
