":START_ID",":END_ID"
"1650","1604"
"1651","1605"
"1652","1604"
"1653","1605"
"1654","1604"
"1655","1605"
"1656","1604"
"1657","1604"
"1658","1605"
"1659","1604"
"1660","1605"
