":START_ID",":END_ID"
"1350","1355"
"1351","1362"
"1352","1369"
"1353","1376"
"1354","1383"
