":START_ID",":END_ID"
"3815","3794"
"3816","3795"
"3817","3796"
"3818","3797"
"3819","3798"
"3820","3799"
"3821","3800"
"3822","3801"
"3823","3802"
"3824","3803"
"3825","3804"
"3826","3805"
"3826","3806"
"3827","3807"
"3828","3808"
