":START_ID",":END_ID"
"3687","3674"
"3688","3675"
"3689","3676"
"3690","3677"
"3691","3678"
"3692","3679"
"3692","3680"
"3693","3681"
"3694","3682"
