":START_ID",":END_ID"
"1187","1147"
"1187","1148"
"1187","1149"
"1187","1150"
"1187","1151"
"1187","1152"
"1187","1153"
"1187","1154"
"1187","1155"
"1187","1156"
"1187","1157"
"1187","1158"
"1187","1159"
"1187","1160"
"1187","1161"
"1187","1162"
"1187","1163"
"1187","1164"
"1187","1165"
"1187","1166"
"1187","1167"
"1187","1168"
"1187","1169"
"1187","1170"
"1187","1171"
"1187","1172"
"1187","1173"
"1187","1174"
"1187","1175"
"1187","1176"
"1187","1177"
"1187","1178"
"1187","1179"
"1187","1180"
"1187","1181"
"1187","1182"
"1187","1183"
"1187","1184"
"1187","1185"
"1187","1186"
