":START_ID",":END_ID"
"1454","1510"
"1455","1511"
"1456","1512"
"1457","1513"
"1458","1514"
"1459","1515"
"1460","1515"
"1461","1515"
"1462","1516"
"1463","1517"
"1464","1517"
"1465","1517"
"1466","1517"
"1467","1517"
"1468","1518"
"1469","1518"
"1470","1518"
"1471","1519"
"1472","1519"
"1473","1519"
"1474","1520"
"1475","1520"
"1476","1520"
"1477","1520"
"1478","1520"
"1479","1520"
"1480","1520"
"1481","1520"
"1482","1521"
"1483","1521"
"1484","1521"
"1485","1522"
"1486","1522"
"1487","1523"
"1488","1523"
"1489","1523"
"1490","1524"
"1491","1524"
"1492","1524"
"1493","1524"
"1494","1525"
"1495","1525"
"1496","1525"
"1497","1525"
"1498","1526"
"1499","1526"
"1500","1526"
"1501","1526"
"1502","1526"
"1503","1526"
"1504","1526"
"1505","1526"
"1506","1526"
"1507","1526"
"1508","1526"
"1509","1526"
