":START_ID",":END_ID"
"1727","1726"
"1728","1727"
"1729","1728"
"1730","1729"
"1731","1730"
"1732","1731"
"1733","1732"
"1734","1733"
"1735","1734"
"1736","1735"
"1737","1736"
"1738","1737"
"1739","1738"
"1740","1739"
"1741","1740"
"1742","1741"
"1743","1742"
"1744","1743"
