":START_ID",":END_ID"
"1504","1678"
"1504","1679"
"1504","1680"
"1504","1681"
"1504","1682"
"1504","1683"
"1504","1685"
"1504","1686"
"1504","1687"
"1504","1688"
"1504","1689"
"1504","1691"
"1505","1684"
"1505","1690"
"1506","1678"
"1506","1679"
"1506","1680"
"1506","1681"
"1506","1682"
"1506","1683"
"1506","1685"
"1506","1686"
"1506","1687"
"1506","1688"
"1506","1689"
"1506","1691"
