":START_ID",":END_ID"
"1445","1456"
"1446","1463"
"1447","1470"
"1448","1477"
"1449","1484"
"1450","1491"
"1451","1498"
"1452","1505"
"1453","1512"
"1454","1519"
"1455","1542"
