":START_ID",":END_ID"
"1659","1712"
"1660","1713"
"1660","1714"
"1660","1715"
"1661","1716"
"1661","1717"
"1661","1718"
"1662","1719"
"1662","1720"
"1663","1721"
"1663","1722"
"1664","1723"
"1664","1724"
