":START_ID",":END_ID"
"1434","1605"
"1434","1606"
"1434","1607"
"1434","1608"
"1434","1609"
"1434","1610"
"1434","1612"
"1434","1613"
"1434","1614"
"1434","1615"
"1434","1616"
"1434","1618"
"1435","1611"
"1435","1617"
"1436","1605"
"1436","1606"
"1436","1607"
"1436","1608"
"1436","1609"
"1436","1610"
"1436","1612"
"1436","1613"
"1436","1614"
"1436","1615"
"1436","1616"
"1436","1618"
