":START_ID",":END_ID"
"1672","1630"
"1673","1630"
"1674","1631"
"1675","1631"
"1676","1632"
"1677","1631"
"1678","1633"
"1679","1634"
"1680","1634"
"1681","1635"
"1682","1635"
