":START_ID",":END_ID"
"1096","1086"
"1096","1087"
"1096","1088"
"1096","1089"
"1096","1090"
"1096","1091"
"1096","1092"
"1096","1093"
"1096","1094"
"1096","1095"
