":START_ID",":END_ID"
"1690","1748"
"1691","1749"
"1692","1750"
"1693","1751"
"1694","1752"
"1695","1753"
"1696","1753"
"1697","1753"
"1698","1754"
"1699","1755"
"1700","1755"
"1701","1755"
"1702","1755"
"1703","1755"
"1704","1756"
"1705","1756"
"1706","1756"
"1707","1757"
"1708","1757"
"1709","1757"
"1710","1758"
"1711","1758"
"1712","1758"
"1713","1758"
"1714","1758"
"1715","1758"
"1716","1758"
"1717","1758"
"1718","1759"
"1719","1759"
"1720","1759"
"1721","1760"
"1722","1760"
"1723","1761"
"1724","1761"
"1725","1761"
"1726","1762"
"1727","1762"
"1728","1762"
"1729","1762"
"1730","1763"
"1731","1763"
"1732","1763"
"1733","1763"
"1734","1764"
"1735","1764"
"1736","1764"
"1737","1764"
"1738","1764"
"1739","1764"
"1740","1764"
"1741","1764"
"1742","1764"
"1743","1764"
"1744","1764"
"1745","1764"
"1746","1765"
"1747","1767"
