":START_ID",":END_ID"
"1394","1402"
"1395","1403"
"1395","1404"
"1396","1405"
"1442","1418"
"1443","1419"
"1444","1420"
"1445","1421"
"1446","1422"
"1447","1423"
"1448","1424"
"1449","1425"
"1450","1426"
"1451","1427"
"1452","1428"
"1453","1429"
