":START_ID",":END_ID"
"1583","1639"
"1584","1640"
"1585","1641"
"1586","1642"
"1587","1643"
"1588","1644"
"1589","1644"
"1590","1644"
"1591","1645"
"1592","1646"
"1593","1646"
"1594","1646"
"1595","1646"
"1596","1646"
"1597","1647"
"1598","1647"
"1599","1647"
"1600","1648"
"1601","1648"
"1602","1648"
"1603","1649"
"1604","1649"
"1605","1649"
"1606","1649"
"1607","1649"
"1608","1649"
"1609","1649"
"1610","1649"
"1611","1650"
"1612","1650"
"1613","1650"
"1614","1651"
"1615","1651"
"1616","1652"
"1617","1652"
"1618","1652"
"1619","1653"
"1620","1653"
"1621","1653"
"1622","1653"
"1623","1654"
"1624","1654"
"1625","1654"
"1626","1654"
"1627","1655"
"1628","1655"
"1629","1655"
"1630","1655"
"1631","1655"
"1632","1655"
"1633","1655"
"1634","1655"
"1635","1655"
"1636","1655"
"1637","1655"
"1638","1655"
