":START_ID",":END_ID"
"1430","1394"
"1431","1394"
"1432","1395"
"1433","1396"
"1434","1395"
"1435","1396"
"1436","1395"
"1437","1395"
"1438","1396"
"1439","1397"
"1440","1397"
