":START_ID",":END_ID"
"1371","1335"
"1372","1336"
"1377","1337"
"1378","1338"
"1379","1339"
"1384","1340"
"1385","1341"
"1386","1342"
"1391","1343"
"1392","1344"
"1393","1345"
"1398","1346"
"1399","1347"
"1400","1348"
"1405","1349"
"1406","1350"
"1407","1351"
"1412","1352"
"1413","1353"
"1414","1354"
"1419","1355"
"1420","1356"
"1421","1357"
"1426","1358"
"1427","1359"
"1428","1360"
"1433","1361"
