":START_ID",":END_ID"
"3847","3856"
"3847","3855"
"3847","3858"
"3847","3857"
"3847","3854"
"3848","3850"
"3848","3851"
"3848","3852"
"3848","3849"
"3848","3853"
