":START_ID",":END_ID"
"1528","1527"
"1529","1528"
"1530","1529"
"1531","1530"
"1532","1531"
"1533","1532"
"1534","1533"
"1535","1534"
"1536","1535"
"1537","1536"
"1538","1537"
"1539","1538"
"1540","1539"
"1541","1540"
"1542","1541"
"1543","1542"
"1544","1543"
"1545","1544"
