":START_ID",":END_ID"
"1656","1709"
"1657","1710"
"1657","1711"
"1657","1712"
"1658","1713"
"1658","1714"
"1658","1715"
"1659","1716"
"1659","1717"
"1660","1718"
"1660","1719"
"1661","1720"
"1661","1721"
