":START_ID",":END_ID"
"3800","3809"
"3800","3808"
"3800","3811"
"3800","3810"
"3800","3807"
"3801","3803"
"3801","3804"
"3801","3805"
"3801","3802"
"3801","3806"
