":START_ID",":END_ID"
"1492","1556"
"1492","1557"
"1492","1558"
"1492","1559"
"1492","1560"
"1492","1561"
"1492","1562"
"1492","1563"
"1492","1564"
"1492","1565"
"1492","1566"
