":START_ID",":END_ID"
"1483","1447"
"1484","1447"
"1485","1448"
"1486","1449"
"1487","1448"
"1488","1449"
"1489","1448"
"1490","1448"
"1491","1449"
"1492","1450"
"1493","1450"
