":START_ID",":END_ID"
"1455","1463"
"1456","1464"
"1456","1465"
"1457","1466"
"1503","1479"
"1504","1480"
"1505","1481"
"1506","1482"
"1507","1483"
"1508","1484"
"1509","1485"
"1510","1486"
"1511","1487"
"1512","1488"
"1513","1489"
"1514","1490"
