":START_ID",":END_ID"
"1136","1122"
"1136","1123"
"1136","1124"
"1136","1125"
"1136","1126"
"1136","1127"
"1136","1128"
"1136","1129"
"1136","1130"
"1136","1131"
"1136","1132"
"1136","1133"
"1136","1134"
"1136","1135"
