":START_ID",":END_ID"
"3812","3813"
"3812","3814"
"3812","3815"
"3812","3816"
"3812","3817"
"3812","3818"
