":START_ID",":END_ID"
"1517","1521"
"1518","1522"
"1518","1523"
"1519","1524"
"1565","1529"
"1566","1530"
"1567","1531"
"1568","1532"
"1569","1533"
"1570","1534"
"1571","1535"
"1572","1536"
"1573","1537"
"1574","1538"
"1575","1539"
"1576","1540"
