":START_ID",":END_ID"
"3710","3719"
"3710","3718"
"3710","3721"
"3710","3720"
"3710","3717"
"3711","3713"
"3711","3714"
"3711","3715"
"3711","3712"
"3711","3716"
