":START_ID",":END_ID"
"1630","1567"
"1630","1568"
"1630","1569"
"1630","1570"
"1630","1571"
"1630","1572"
"1630","1573"
"1630","1574"
"1630","1575"
"1630","1576"
"1630","1577"
"1630","1578"
"1630","1579"
"1630","1580"
"1630","1581"
"1630","1582"
"1630","1583"
"1630","1584"
"1630","1585"
"1630","1586"
"1630","1587"
"1630","1588"
"1630","1589"
"1630","1590"
"1630","1591"
"1630","1592"
"1630","1593"
"1630","1594"
"1630","1595"
"1630","1596"
"1630","1597"
"1630","1598"
"1630","1599"
"1630","1600"
"1630","1601"
"1630","1602"
"1630","1603"
"1630","1604"
"1630","1605"
"1630","1606"
"1630","1607"
"1630","1608"
"1630","1609"
"1630","1610"
"1630","1611"
"1630","1612"
"1630","1613"
"1630","1614"
"1630","1615"
"1630","1616"
"1630","1617"
"1630","1618"
"1630","1619"
"1630","1620"
"1630","1621"
"1630","1622"
"1630","1623"
"1630","1624"
"1630","1625"
"1630","1626"
"1630","1627"
"1630","1628"
"1630","1629"
