":START_ID",":END_ID"
"3841","3842"
"3841","3843"
"3841","3844"
"3841","3845"
"3841","3846"
