":START_ID",":END_ID"
"1303","1180"
"1303","1181"
"1303","1182"
"1303","1183"
"1303","1184"
"1303","1185"
"1303","1186"
"1303","1187"
"1303","1188"
"1303","1189"
"1303","1190"
"1303","1191"
"1303","1192"
"1303","1193"
"1303","1194"
"1303","1195"
"1303","1196"
"1303","1197"
"1303","1198"
"1303","1199"
"1303","1200"
"1303","1201"
"1303","1202"
"1303","1203"
"1303","1204"
"1303","1205"
"1303","1206"
"1303","1207"
"1303","1208"
"1303","1209"
"1303","1210"
"1303","1211"
"1303","1212"
"1303","1213"
"1303","1214"
"1303","1215"
"1303","1216"
"1303","1217"
"1303","1218"
"1303","1219"
"1303","1220"
"1303","1221"
"1303","1222"
"1303","1223"
"1303","1224"
"1303","1225"
"1303","1226"
"1303","1227"
"1303","1228"
"1303","1229"
"1303","1230"
"1303","1231"
"1303","1232"
"1303","1233"
"1303","1234"
"1303","1235"
"1303","1236"
"1303","1237"
"1303","1238"
"1303","1239"
"1303","1240"
"1303","1241"
"1303","1242"
"1303","1243"
"1303","1244"
"1303","1245"
"1303","1246"
"1303","1247"
"1303","1248"
"1303","1249"
"1303","1250"
"1303","1251"
"1303","1252"
"1303","1253"
"1303","1254"
"1303","1255"
"1303","1256"
"1303","1257"
"1303","1258"
"1303","1259"
"1303","1260"
"1303","1261"
"1303","1262"
"1303","1263"
"1303","1264"
"1303","1265"
"1303","1266"
"1303","1267"
"1303","1268"
"1303","1269"
"1303","1270"
"1303","1271"
"1303","1272"
"1303","1273"
"1303","1274"
"1303","1275"
"1303","1276"
"1303","1277"
"1303","1278"
"1303","1279"
"1303","1280"
"1303","1281"
"1303","1282"
"1303","1283"
"1303","1284"
"1303","1285"
"1303","1286"
"1303","1287"
"1303","1288"
"1303","1289"
"1303","1290"
"1303","1291"
"1303","1292"
"1303","1293"
"1303","1294"
"1303","1295"
"1303","1296"
"1303","1297"
"1303","1298"
"1303","1299"
"1303","1300"
"1303","1301"
"1303","1302"
