":START_ID",":END_ID"
"1758","1695"
"1758","1696"
"1758","1697"
"1758","1698"
"1758","1699"
"1758","1700"
"1758","1701"
"1758","1702"
"1758","1703"
"1758","1704"
"1758","1705"
"1758","1706"
"1758","1707"
"1758","1708"
"1758","1709"
"1758","1710"
"1758","1711"
"1758","1712"
"1758","1713"
"1758","1714"
"1758","1715"
"1758","1716"
"1758","1717"
"1758","1718"
"1758","1719"
"1758","1720"
"1758","1721"
"1758","1722"
"1758","1723"
"1758","1724"
"1758","1725"
"1758","1726"
"1758","1727"
"1758","1728"
"1758","1729"
"1758","1730"
"1758","1731"
"1758","1732"
"1758","1733"
"1758","1734"
"1758","1735"
"1758","1736"
"1758","1737"
"1758","1738"
"1758","1739"
"1758","1740"
"1758","1741"
"1758","1742"
"1758","1743"
"1758","1744"
"1758","1745"
"1758","1746"
"1758","1747"
"1758","1748"
"1758","1749"
"1758","1750"
"1758","1751"
"1758","1752"
"1758","1753"
"1758","1754"
"1758","1755"
"1758","1756"
"1758","1757"
