":START_ID",":END_ID"
"1523","1527"
"1524","1528"
"1524","1529"
"1525","1530"
"1571","1535"
"1572","1536"
"1573","1537"
"1574","1538"
"1575","1539"
"1576","1540"
"1577","1541"
"1578","1542"
"1579","1543"
"1580","1544"
"1581","1545"
"1582","1546"
