":START_ID",":END_ID"
"1423","1387"
"1424","1387"
"1425","1388"
"1426","1389"
"1427","1388"
"1428","1389"
"1429","1388"
"1430","1388"
"1431","1389"
"1432","1390"
"1433","1390"
