":START_ID",":END_ID"
"1619","1798"
"1619","1799"
"1619","1800"
"1619","1801"
"1619","1802"
"1619","1803"
"1619","1805"
"1619","1806"
"1619","1807"
"1619","1808"
"1619","1809"
"1619","1811"
"1620","1804"
"1620","1810"
"1621","1798"
"1621","1799"
"1621","1800"
"1621","1801"
"1621","1802"
"1621","1803"
"1621","1805"
"1621","1806"
"1621","1807"
"1621","1808"
"1621","1809"
"1621","1811"
