":START_ID",":END_ID"
"1553","1507"
"1554","1508"
"1555","1507"
"1556","1508"
"1557","1507"
"1558","1508"
"1559","1507"
"1560","1507"
"1561","1508"
"1562","1507"
"1563","1508"
