":START_ID",":END_ID"
"1756","1693"
"1756","1694"
"1756","1695"
"1756","1696"
"1756","1697"
"1756","1698"
"1756","1699"
"1756","1700"
"1756","1701"
"1756","1702"
"1756","1703"
"1756","1704"
"1756","1705"
"1756","1706"
"1756","1707"
"1756","1708"
"1756","1709"
"1756","1710"
"1756","1711"
"1756","1712"
"1756","1713"
"1756","1714"
"1756","1715"
"1756","1716"
"1756","1717"
"1756","1718"
"1756","1719"
"1756","1720"
"1756","1721"
"1756","1722"
"1756","1723"
"1756","1724"
"1756","1725"
"1756","1726"
"1756","1727"
"1756","1728"
"1756","1729"
"1756","1730"
"1756","1731"
"1756","1732"
"1756","1733"
"1756","1734"
"1756","1735"
"1756","1736"
"1756","1737"
"1756","1738"
"1756","1739"
"1756","1740"
"1756","1741"
"1756","1742"
"1756","1743"
"1756","1744"
"1756","1745"
"1756","1746"
"1756","1747"
"1756","1748"
"1756","1749"
"1756","1750"
"1756","1751"
"1756","1752"
"1756","1753"
"1756","1754"
"1756","1755"
