":START_ID",":END_ID"
"1650","1608"
"1651","1608"
"1652","1609"
"1653","1609"
"1654","1610"
"1655","1609"
"1656","1611"
"1657","1612"
"1658","1612"
"1659","1613"
"1660","1613"
