":START_ID",":END_ID"
"1486","1628"
"1487","1628"
"1488","1628"
"1489","1628"
"1490","1628"
"1491","1628"
"1492","1628"
"1493","1628"
"1494","1628"
"1495","1628"
