":START_ID",":END_ID"
"1445","1456"
"1445","1457"
"1445","1458"
"1445","1459"
"1445","1460"
"1445","1461"
"1445","1462"
"1446","1463"
"1446","1464"
"1446","1465"
"1446","1466"
"1446","1467"
"1446","1468"
"1446","1469"
"1447","1470"
"1447","1471"
"1447","1472"
"1447","1473"
"1447","1474"
"1447","1475"
"1447","1476"
"1448","1477"
"1448","1478"
"1448","1479"
"1448","1480"
"1448","1481"
"1448","1482"
"1448","1483"
"1449","1484"
"1449","1485"
"1449","1486"
"1449","1487"
"1449","1488"
"1449","1489"
"1449","1490"
"1450","1491"
"1450","1492"
"1450","1493"
"1450","1494"
"1450","1495"
"1450","1496"
"1450","1497"
"1451","1498"
"1451","1499"
"1451","1500"
"1451","1501"
"1451","1502"
"1451","1503"
"1451","1504"
"1452","1505"
"1452","1506"
"1452","1507"
"1452","1508"
"1452","1509"
"1452","1510"
"1452","1511"
"1453","1512"
"1453","1513"
"1453","1514"
"1453","1515"
"1453","1516"
"1453","1517"
"1453","1518"
"1454","1519"
"1454","1520"
"1454","1521"
"1454","1522"
"1454","1523"
"1454","1524"
"1454","1525"
"1454","1526"
"1454","1527"
"1454","1528"
"1454","1529"
"1454","1530"
"1454","1531"
"1454","1532"
"1454","1533"
"1454","1534"
"1454","1535"
"1454","1536"
"1454","1537"
"1454","1538"
"1454","1539"
"1454","1540"
"1454","1541"
"1455","1542"
"1455","1543"
"1455","1544"
