":START_ID",":END_ID"
"3842","3851"
"3842","3850"
"3842","3853"
"3842","3852"
"3842","3849"
"3843","3845"
"3843","3846"
"3843","3847"
"3843","3844"
"3843","3848"
