":START_ID",":END_ID"
"1495","1435"
"1496","1436"
"1501","1437"
"1502","1438"
"1503","1439"
"1508","1440"
"1509","1441"
"1510","1442"
"1515","1443"
"1516","1444"
"1517","1445"
"1522","1446"
"1523","1447"
"1524","1448"
"1529","1449"
"1530","1450"
"1531","1451"
"1536","1452"
"1537","1453"
"1538","1454"
"1543","1455"
"1544","1456"
"1545","1457"
"1550","1458"
"1551","1459"
"1552","1460"
"1557","1461"
"1558","1462"
"1559","1463"
"1560","1464"
"1561","1465"
"1562","1466"
"1563","1467"
"1564","1468"
"1565","1469"
"1566","1470"
"1567","1471"
"1568","1472"
"1569","1473"
"1570","1474"
"1571","1475"
"1572","1476"
"1573","1477"
"1574","1478"
"1575","1479"
"1576","1480"
"1577","1481"
"1578","1482"
"1579","1483"
"1580","1484"
