":START_ID",":END_ID"
"1660","1618"
"1661","1618"
"1662","1619"
"1663","1619"
"1664","1620"
"1665","1619"
"1666","1621"
"1667","1622"
"1668","1622"
"1669","1623"
"1670","1623"
