":START_ID",":END_ID"
"1182","1142"
"1182","1143"
"1182","1144"
"1182","1145"
"1182","1146"
"1182","1147"
"1182","1148"
"1182","1149"
"1182","1150"
"1182","1151"
"1182","1152"
"1182","1153"
"1182","1154"
"1182","1155"
"1182","1156"
"1182","1157"
"1182","1158"
"1182","1159"
"1182","1160"
"1182","1161"
"1182","1162"
"1182","1163"
"1182","1164"
"1182","1165"
"1182","1166"
"1182","1167"
"1182","1168"
"1182","1169"
"1182","1170"
"1182","1171"
"1182","1172"
"1182","1173"
"1182","1174"
"1182","1175"
"1182","1176"
"1182","1177"
"1182","1178"
"1182","1179"
"1182","1180"
"1182","1181"
