":START_ID",":END_ID"
"1644","1643"
"1645","1644"
"1646","1645"
"1647","1646"
"1648","1647"
"1649","1648"
"1650","1649"
"1651","1650"
"1652","1651"
"1653","1652"
"1654","1653"
"1655","1654"
"1656","1655"
"1657","1656"
"1658","1657"
"1659","1658"
"1660","1659"
"1661","1660"
