":START_ID",":END_ID"
"1362","1363"
"1362","1364"
"1362","1365"
"1362","1366"
"1362","1367"
"1362","1368"
"1362","1369"
