":START_ID",":END_ID"
"1781","1800"
"1789","1801"
"1789","1802"
"1790","1801"
"1790","1802"
"1795","1804"
"1796","1805"
