":START_ID",":END_ID"
"1742","1762"
"1750","1763"
"1750","1764"
"1751","1763"
"1751","1764"
"1756","1766"
"1757","1767"
