":START_ID",":END_ID"
"1501","1500"
"1502","1501"
"1503","1502"
"1504","1503"
"1505","1504"
"1506","1505"
"1507","1506"
"1508","1507"
"1509","1508"
"1510","1509"
"1511","1510"
"1512","1511"
"1513","1512"
"1514","1513"
"1515","1514"
"1516","1515"
"1517","1516"
"1518","1517"
