":START_ID",":END_ID"
"3831","3832"
"3831","3833"
"3831","3834"
"3831","3835"
"3831","3836"
"3831","3837"
