":START_ID",":END_ID"
"1444","1454"
"1445","1461"
"1446","1468"
"1447","1475"
"1448","1482"
"1449","1489"
"1450","1496"
"1451","1503"
"1452","1510"
"1453","1517"
