":START_ID",":END_ID"
"1468","1402"
"1469","1403"
"1474","1404"
"1475","1405"
"1476","1406"
"1477","1407"
"1478","1408"
"1479","1409"
"1480","1410"
"1481","1411"
"1482","1412"
"1483","1413"
"1488","1414"
"1489","1415"
"1490","1416"
"1491","1417"
"1492","1418"
"1493","1419"
"1498","1420"
"1499","1421"
"1500","1422"
"1505","1423"
"1506","1424"
"1507","1425"
"1512","1426"
"1513","1427"
"1514","1428"
"1519","1429"
"1520","1430"
"1521","1431"
"1522","1432"
"1523","1433"
"1524","1434"
"1525","1435"
"1526","1436"
"1527","1437"
"1528","1438"
"1529","1439"
"1530","1440"
"1531","1441"
"1532","1442"
"1533","1443"
"1534","1444"
"1535","1445"
"1536","1446"
"1537","1447"
"1538","1448"
"1539","1449"
"1540","1450"
"1541","1451"
"1542","1452"
"1543","1453"
"1544","1454"
"1545","1455"
"1546","1456"
