":START_ID",":END_ID"
"30","31"
"30","32"
"30","33"
"35","36"
"36","37"
"36","38"
"35","39"
"35","30"
"35","40"
"35","41"
"41","42"
"41","43"
"41","44"
"35","45"
"45","46"
"35","47"
"47","48"
"47","49"
"47","50"
"47","44"
"35","51"
"35","52"
"53","54"
"53","55"
"53","56"
"53","57"
"53","58"
"53","40"
"53","59"
"53","60"
"53","30"
"53","61"
"53","62"
"53","63"
"53","64"
"53","65"
"53","66"
"66","67"
"66","68"
"66","69"
"53","34"
"53","45"
"45","46"
"53","70"
"70","71"
"70","72"
"53","73"
"53","74"
"74","75"
"74","76"
"74","77"
"74","78"
"74","79"
"74","80"
"81","82"
"81","34"
"81","64"
"81","59"
"81","52"
"81","83"
"81","84"
"81","85"
"81","86"
"86","87"
"86","88"
"81","89"
"81","90"
"81","91"
"81","92"
"92","93"
"92","94"
"92","95"
"81","30"
