":START_ID",":END_ID"
"1486","1496"
"1486","1497"
"1486","1498"
"1486","1499"
"1486","1500"
"1486","1501"
"1486","1502"
"1487","1503"
"1487","1504"
"1487","1505"
"1487","1506"
"1487","1507"
"1487","1508"
"1487","1509"
"1488","1510"
"1488","1511"
"1488","1512"
"1488","1513"
"1488","1514"
"1488","1515"
"1488","1516"
"1489","1517"
"1489","1518"
"1489","1519"
"1489","1520"
"1489","1521"
"1489","1522"
"1489","1523"
"1490","1524"
"1490","1525"
"1490","1526"
"1490","1527"
"1490","1528"
"1490","1529"
"1490","1530"
"1491","1531"
"1491","1532"
"1491","1533"
"1491","1534"
"1491","1535"
"1491","1536"
"1491","1537"
"1492","1538"
"1492","1539"
"1492","1540"
"1492","1541"
"1492","1542"
"1492","1543"
"1492","1544"
"1493","1545"
"1493","1546"
"1493","1547"
"1493","1548"
"1493","1549"
"1493","1550"
"1493","1551"
"1494","1552"
"1494","1553"
"1494","1554"
"1494","1555"
"1494","1556"
"1494","1557"
"1494","1558"
"1495","1559"
"1495","1560"
"1495","1561"
"1495","1562"
"1495","1563"
"1495","1564"
"1495","1565"
"1495","1566"
"1495","1567"
"1495","1568"
"1495","1569"
"1495","1570"
"1495","1571"
"1495","1572"
"1495","1573"
"1495","1574"
"1495","1575"
"1495","1576"
"1495","1577"
"1495","1578"
"1495","1579"
"1495","1580"
"1495","1581"
