":START_ID",":END_ID"
"26","17"
"27","18"
"28","19"
"29","20"
"50","21"
"68","22"
"68","23"
