":START_ID",":END_ID"
"21","24"
"21","25"
"21","30"
"23","21"
"23","22"
"23","19"
"23","26"
"23","31"
"23","32"
"23","29"
"23","40"
"23","44"
"33","34"
"22","35"
"22","36"
"36","28"
"22","38"
"38","39"
"38","41"
"32","42"
"32","43"
"46","21"
"46","45"
"46","48"
"48","49"
"48","50"
"48","51"
"52","53"
"52","54"
"46","55"
"46","56"
"46","52"
"46","57"
"46","58"
"58","59"
"58","60"
"58","61"
"62","63"
"46","64"
"46","65"
"46","66"
"46","67"
"46","68"
"46","69"
"46","70"
"46","71"
"48","72"
"48","73"
"74","75"
"75","78"
"78","77"
"75","76"
"76","79"
"76","80"
"74","95"
"74","21"
"74","33"
"74","62"
"74","82"
"74","81"
"74","83"
"83","84"
"83","85"
"83","86"
"83","87"
"74","88"
"88","89"
"88","90"
"88","91"
"23","37"
"48","92"
"46","62"
"46","20"
"46","27"
"46","47"
"23","20"
"23","33"
"23","47"
"23","27"
"93","95"
"93","94"
"94","97"
"97","96"
"93","33"
