":START_ID",":END_ID"
"1179","1139"
"1179","1140"
"1179","1141"
"1179","1142"
"1179","1143"
"1179","1144"
"1179","1145"
"1179","1146"
"1179","1147"
"1179","1148"
"1179","1149"
"1179","1150"
"1179","1151"
"1179","1152"
"1179","1153"
"1179","1154"
"1179","1155"
"1179","1156"
"1179","1157"
"1179","1158"
"1179","1159"
"1179","1160"
"1179","1161"
"1179","1162"
"1179","1163"
"1179","1164"
"1179","1165"
"1179","1166"
"1179","1167"
"1179","1168"
"1179","1169"
"1179","1170"
"1179","1171"
"1179","1172"
"1179","1173"
"1179","1174"
"1179","1175"
"1179","1176"
"1179","1177"
"1179","1178"
