":START_ID",":END_ID"
"1337","1436"
"1339","1437"
"1339","1438"
"1340","1439"
"1342","1440"
"1342","1441"
"1342","1442"
"1342","1443"
"1342","1444"
"1342","1445"
"1342","1446"
"1343","1447"
"1345","1448"
"1345","1449"
"1345","1450"
"1345","1451"
"1346","1452"
"1348","1453"
"1348","1454"
"1348","1455"
"1348","1456"
"1348","1457"
"1349","1458"
"1351","1459"
"1351","1460"
"1351","1461"
"1351","1462"
"1352","1463"
"1353","1464"
"1353","1465"
"1353","1466"
"1354","1467"
"1354","1468"
"1355","1469"
"1356","1470"
"1357","1471"
"1357","1472"
"1358","1473"
"1359","1474"
"1360","1475"
"1360","1476"
"1361","1477"
"1362","1478"
"1363","1479"
"1363","1480"
