":START_ID",":END_ID"
"1378","1431"
"1379","1432"
"1379","1433"
"1379","1434"
"1380","1435"
"1380","1436"
"1380","1437"
"1381","1438"
"1381","1439"
"1382","1440"
"1382","1441"
"1383","1442"
"1383","1443"
