":START_ID",":END_ID"
"1394","1398"
"1395","1399"
"1395","1400"
"1396","1401"
"1442","1406"
"1443","1407"
"1444","1408"
"1445","1409"
"1446","1410"
"1447","1411"
"1448","1412"
"1449","1413"
"1450","1414"
"1451","1415"
"1452","1416"
"1453","1417"
