":START_ID",":END_ID"
"1102","1092"
"1102","1093"
"1102","1094"
"1102","1095"
"1102","1096"
"1102","1097"
"1102","1098"
"1102","1099"
"1102","1100"
"1102","1101"
