":START_ID",":END_ID"
"1555","1509"
"1556","1510"
"1557","1509"
"1558","1510"
"1559","1509"
"1560","1510"
"1561","1509"
"1562","1509"
"1563","1510"
"1564","1509"
"1565","1510"
