":START_ID",":END_ID"
"1461","1396"
"1462","1397"
"1467","1398"
"1468","1399"
"1469","1400"
"1474","1401"
"1475","1402"
"1476","1403"
"1481","1404"
"1482","1405"
"1483","1406"
"1488","1407"
"1489","1408"
"1490","1409"
"1495","1410"
"1496","1411"
"1497","1412"
"1502","1413"
"1503","1414"
"1504","1415"
"1509","1416"
"1510","1417"
"1511","1418"
"1516","1419"
"1517","1420"
"1518","1421"
"1523","1422"
"1524","1423"
"1525","1424"
"1526","1425"
"1527","1426"
"1528","1427"
"1529","1428"
"1530","1429"
"1531","1430"
"1532","1431"
"1533","1432"
"1534","1433"
"1535","1434"
"1536","1435"
"1537","1436"
"1538","1437"
"1539","1438"
"1540","1439"
"1541","1440"
"1542","1441"
"1543","1442"
"1544","1443"
"1545","1444"
"1546","1445"
"1547","1446"
"1548","1447"
"1549","1448"
"1550","1449"
