":START_ID",":END_ID"
"1116","1094"
"1116","1095"
"1116","1096"
"1116","1097"
"1116","1098"
"1116","1099"
"1116","1100"
"1116","1101"
"1116","1102"
"1116","1103"
"1116","1104"
"1116","1105"
"1116","1106"
"1116","1107"
"1116","1108"
"1116","1109"
"1116","1110"
"1116","1111"
"1116","1112"
"1116","1113"
"1116","1114"
"1116","1115"
