":START_ID",":END_ID"
"1601","1775"
"1601","1776"
"1601","1777"
"1601","1778"
"1601","1779"
"1601","1780"
"1601","1782"
"1601","1783"
"1601","1784"
"1601","1785"
"1601","1786"
"1601","1788"
"1602","1781"
"1602","1787"
"1603","1775"
"1603","1776"
"1603","1777"
"1603","1778"
"1603","1779"
"1603","1780"
"1603","1782"
"1603","1783"
"1603","1784"
"1603","1785"
"1603","1786"
"1603","1788"
