":START_ID",":END_ID"
"3863","3872"
"3863","3871"
"3863","3874"
"3863","3873"
"3863","3870"
"3864","3866"
"3864","3867"
"3864","3868"
"3864","3865"
"3864","3869"
