":START_ID",":END_ID"
"1442","1396"
"1443","1397"
"1444","1396"
"1445","1397"
"1446","1396"
"1447","1397"
"1448","1396"
"1449","1396"
"1450","1397"
"1451","1396"
"1452","1397"
