":START_ID",":END_ID"
"3784","3771"
"3785","3772"
"3786","3773"
"3787","3774"
"3788","3775"
"3789","3776"
"3789","3777"
"3790","3778"
"3791","3779"
