":START_ID",":END_ID"
"1580","1636"
"1581","1637"
"1582","1638"
"1583","1639"
"1584","1640"
"1585","1641"
"1586","1641"
"1587","1641"
"1588","1642"
"1589","1643"
"1590","1643"
"1591","1643"
"1592","1643"
"1593","1643"
"1594","1644"
"1595","1644"
"1596","1644"
"1597","1645"
"1598","1645"
"1599","1645"
"1600","1646"
"1601","1646"
"1602","1646"
"1603","1646"
"1604","1646"
"1605","1646"
"1606","1646"
"1607","1646"
"1608","1647"
"1609","1647"
"1610","1647"
"1611","1648"
"1612","1648"
"1613","1649"
"1614","1649"
"1615","1649"
"1616","1650"
"1617","1650"
"1618","1650"
"1619","1650"
"1620","1651"
"1621","1651"
"1622","1651"
"1623","1651"
"1624","1652"
"1625","1652"
"1626","1652"
"1627","1652"
"1628","1652"
"1629","1652"
"1630","1652"
"1631","1652"
"1632","1652"
"1633","1652"
"1634","1652"
"1635","1652"
