":START_ID",":END_ID"
"1696","1754"
"1697","1755"
"1698","1756"
"1699","1757"
"1700","1758"
"1701","1759"
"1702","1759"
"1703","1759"
"1704","1760"
"1705","1761"
"1706","1761"
"1707","1761"
"1708","1761"
"1709","1761"
"1710","1762"
"1711","1762"
"1712","1762"
"1713","1763"
"1714","1763"
"1715","1763"
"1716","1764"
"1717","1764"
"1718","1764"
"1719","1764"
"1720","1764"
"1721","1764"
"1722","1764"
"1723","1764"
"1724","1765"
"1725","1765"
"1726","1765"
"1727","1766"
"1728","1766"
"1729","1767"
"1730","1767"
"1731","1767"
"1732","1768"
"1733","1768"
"1734","1768"
"1735","1768"
"1736","1769"
"1737","1769"
"1738","1769"
"1739","1769"
"1740","1770"
"1741","1770"
"1742","1770"
"1743","1770"
"1744","1770"
"1745","1770"
"1746","1770"
"1747","1770"
"1748","1770"
"1749","1770"
"1750","1770"
"1751","1770"
"1752","1771"
"1753","1773"
