":START_ID",":END_ID"
"1170","1130"
"1170","1131"
"1170","1132"
"1170","1133"
"1170","1134"
"1170","1135"
"1170","1136"
"1170","1137"
"1170","1138"
"1170","1139"
"1170","1140"
"1170","1141"
"1170","1142"
"1170","1143"
"1170","1144"
"1170","1145"
"1170","1146"
"1170","1147"
"1170","1148"
"1170","1149"
"1170","1150"
"1170","1151"
"1170","1152"
"1170","1153"
"1170","1154"
"1170","1155"
"1170","1156"
"1170","1157"
"1170","1158"
"1170","1159"
"1170","1160"
"1170","1161"
"1170","1162"
"1170","1163"
"1170","1164"
"1170","1165"
"1170","1166"
"1170","1167"
"1170","1168"
"1170","1169"
