":START_ID",":END_ID"
"1089","1079"
"1089","1080"
"1089","1081"
"1089","1082"
"1089","1083"
"1089","1084"
"1089","1085"
"1089","1086"
"1089","1087"
"1089","1088"
