":START_ID",":END_ID"
"1672","1636"
"1673","1636"
"1674","1637"
"1675","1638"
"1676","1637"
"1677","1638"
"1678","1637"
"1679","1637"
"1680","1638"
"1681","1639"
"1682","1639"
