":START_ID",":END_ID"
"1523","1522"
"1524","1523"
"1525","1524"
"1526","1525"
"1527","1526"
"1528","1527"
"1529","1528"
"1530","1529"
"1531","1530"
"1532","1531"
"1533","1532"
"1534","1533"
"1535","1534"
"1536","1535"
"1537","1536"
"1538","1537"
"1539","1538"
"1540","1539"
