":START_ID",":END_ID"
"3707","3718"
"3707","3717"
"3707","3720"
"3707","3719"
"3707","3716"
"3708","3712"
"3708","3713"
"3708","3714"
"3708","3711"
"3708","3715"
