":START_ID",":END_ID"
"1331","1313"
"1332","1314"
"1333","1315"
"1334","1316"
"1335","1317"
"1336","1318"
"1337","1319"
"1337","1320"
"1338","1321"
"1339","1322"
"1340","1323"
"1341","1324"
"1342","1325"
"1343","1326"
"1344","1327"
"1345","1328"
"1345","1329"
"1346","1330"
