":START_ID",":END_ID"
"1114","1092"
"1114","1093"
"1114","1094"
"1114","1095"
"1114","1096"
"1114","1097"
"1114","1098"
"1114","1099"
"1114","1100"
"1114","1101"
"1114","1102"
"1114","1103"
"1114","1104"
"1114","1105"
"1114","1106"
"1114","1107"
"1114","1108"
"1114","1109"
"1114","1110"
"1114","1111"
"1114","1112"
"1114","1113"
