":START_ID",":END_ID"
"1641","1670"
"1641","1681"
"1641","1682"
"1641","1683"
"1643","1671"
"1643","1673"
"1643","1673"
"1645","1674"
"1646","1675"
"1646","1676"
"1647","1666"
"1647","1667"
"1648","1664"
"1648","1665"
"1650","1677"
"1651","1678"
"1652","1668"
"1654","1669"
"1655","1679"
"1655","1680"
