":START_ID",":END_ID"
"3623","3610"
"3624","3611"
"3625","3612"
"3626","3613"
"3627","3614"
"3628","3615"
"3628","3616"
"3629","3617"
"3630","3618"
