":START_ID",":END_ID"
"1766","1703"
"1766","1704"
"1766","1705"
"1766","1706"
"1766","1707"
"1766","1708"
"1766","1709"
"1766","1710"
"1766","1711"
"1766","1712"
"1766","1713"
"1766","1714"
"1766","1715"
"1766","1716"
"1766","1717"
"1766","1718"
"1766","1719"
"1766","1720"
"1766","1721"
"1766","1722"
"1766","1723"
"1766","1724"
"1766","1725"
"1766","1726"
"1766","1727"
"1766","1728"
"1766","1729"
"1766","1730"
"1766","1731"
"1766","1732"
"1766","1733"
"1766","1734"
"1766","1735"
"1766","1736"
"1766","1737"
"1766","1738"
"1766","1739"
"1766","1740"
"1766","1741"
"1766","1742"
"1766","1743"
"1766","1744"
"1766","1745"
"1766","1746"
"1766","1747"
"1766","1748"
"1766","1749"
"1766","1750"
"1766","1751"
"1766","1752"
"1766","1753"
"1766","1754"
"1766","1755"
"1766","1756"
"1766","1757"
"1766","1758"
"1766","1759"
"1766","1760"
"1766","1761"
"1766","1762"
"1766","1763"
"1766","1764"
"1766","1765"
