":START_ID",":END_ID"
"1572","1571"
"1573","1572"
"1574","1573"
"1575","1574"
"1576","1575"
"1577","1576"
"1578","1577"
"1579","1578"
"1580","1579"
"1581","1580"
"1582","1581"
"1583","1582"
"1584","1583"
"1585","1584"
"1586","1585"
"1587","1586"
"1588","1587"
"1589","1588"
