":START_ID",":END_ID"
"1577","1564"
"1578","1564"
"1579","1564"
"1580","1564"
"1581","1564"
"1582","1564"
"1583","1566"
"1584","1575"
"1585","1564"
"1586","1564"
"1587","1565"
"1588","1566"
"1589","1567"
"1590","1575"
"1591","1564"
"1592","1567"
"1593","1575"
"1594","1564"
"1595","1567"
"1596","1575"
"1597","1564"
"1598","1565"
"1599","1566"
"1600","1567"
"1601","1568"
"1602","1571"
"1603","1573"
"1604","1575"
"1605","1564"
"1606","1567"
"1607","1575"
"1608","1564"
"1609","1567"
"1610","1568"
"1611","1571"
"1612","1573"
"1613","1565"
"1614","1568"
"1615","1571"
"1616","1573"
"1618","1568"
"1619","1571"
"1620","1575"
"1621","1564"
"1622","1565"
"1623","1566"
"1624","1567"
"1625","1568"
"1626","1569"
"1627","1570"
"1628","1571"
"1629","1572"
"1630","1573"
"1631","1574"
"1632","1575"
