":START_ID",":END_ID"
"3681","3668"
"3682","3669"
"3683","3670"
"3684","3671"
"3685","3672"
"3686","3673"
"3686","3674"
"3687","3675"
"3688","3676"
