":START_ID",":END_ID"
"1335","1319"
"1335","1320"
"1335","1321"
"1335","1322"
"1335","1323"
"1335","1324"
"1335","1325"
"1336","1326"
"1336","1327"
"1336","1328"
"1336","1329"
"1336","1330"
"1336","1331"
"1336","1332"
"1336","1333"
"1336","1334"
