":START_ID",":END_ID"
"1172","1132"
"1172","1133"
"1172","1134"
"1172","1135"
"1172","1136"
"1172","1137"
"1172","1138"
"1172","1139"
"1172","1140"
"1172","1141"
"1172","1142"
"1172","1143"
"1172","1144"
"1172","1145"
"1172","1146"
"1172","1147"
"1172","1148"
"1172","1149"
"1172","1150"
"1172","1151"
"1172","1152"
"1172","1153"
"1172","1154"
"1172","1155"
"1172","1156"
"1172","1157"
"1172","1158"
"1172","1159"
"1172","1160"
"1172","1161"
"1172","1162"
"1172","1163"
"1172","1164"
"1172","1165"
"1172","1166"
"1172","1167"
"1172","1168"
"1172","1169"
"1172","1170"
"1172","1171"
