":START_ID",":END_ID"
"1778","1797"
"1786","1798"
"1786","1799"
"1787","1798"
"1787","1799"
"1792","1801"
"1793","1802"
