":START_ID",":END_ID"
"1445","1592"
"1446","1592"
"1447","1592"
"1448","1592"
"1449","1592"
"1450","1592"
"1451","1592"
"1452","1592"
"1453","1592"
"1454","1592"
"1455","1592"
