":START_ID",":END_ID"
"1354","1345"
"1354","1346"
"1354","1347"
"1354","1348"
"1354","1349"
"1356","1350"
"1356","1351"
"1356","1352"
"1356","1353"
