":START_ID",":END_ID"
"3689","3676"
"3690","3677"
"3691","3678"
"3692","3679"
"3693","3680"
"3694","3681"
"3694","3682"
"3695","3683"
"3696","3684"
