":START_ID",":END_ID"
"1726","1713"
"1727","1713"
"1728","1713"
"1729","1713"
"1730","1713"
"1731","1713"
"1732","1715"
"1733","1724"
"1734","1713"
"1735","1713"
"1736","1714"
"1737","1715"
"1738","1716"
"1739","1724"
"1740","1713"
"1741","1716"
"1742","1724"
"1743","1713"
"1744","1716"
"1745","1724"
"1746","1713"
"1747","1714"
"1748","1715"
"1749","1716"
"1750","1717"
"1751","1720"
"1752","1722"
"1753","1724"
"1754","1713"
"1755","1716"
"1756","1724"
"1757","1713"
"1758","1716"
"1759","1717"
"1760","1720"
"1761","1722"
"1762","1714"
"1763","1717"
"1764","1720"
"1765","1722"
"1767","1717"
"1768","1720"
"1769","1724"
"1770","1713"
"1771","1714"
"1772","1715"
"1773","1716"
"1774","1717"
"1775","1718"
"1776","1719"
"1777","1720"
"1778","1721"
"1779","1722"
"1780","1723"
"1781","1724"
"1782","1713"
