":START_ID",":END_ID"
"30","19"
"31","20"
"32","21"
"33","22"
"36","23"
"37","24"
"56","25"
"74","26"
"74","27"
