":START_ID",":END_ID"
"1490","1496"
"1490","1497"
"1490","1498"
"1489","1499"
"1489","1500"
"1489","1501"
"1494","1503"
"1493","1504"
"1494","1505"
