":START_ID",":END_ID"
"1482","1624"
"1483","1624"
"1484","1624"
"1485","1624"
"1486","1624"
"1487","1624"
"1488","1624"
"1489","1624"
"1490","1624"
"1491","1624"
