":START_ID",":END_ID"
"1510","1529"
"1518","1530"
"1518","1531"
"1519","1530"
"1519","1531"
"1524","1533"
"1525","1534"
