":START_ID",":END_ID"
"1587","1574"
"1588","1574"
"1589","1574"
"1590","1574"
"1591","1574"
"1592","1574"
"1593","1576"
"1594","1585"
"1595","1574"
"1596","1574"
"1597","1575"
"1598","1576"
"1599","1577"
"1600","1585"
"1601","1574"
"1602","1577"
"1603","1585"
"1604","1574"
"1605","1577"
"1606","1585"
"1607","1574"
"1608","1575"
"1609","1576"
"1610","1577"
"1611","1578"
"1612","1581"
"1613","1583"
"1614","1585"
"1615","1574"
"1616","1577"
"1617","1585"
"1618","1574"
"1619","1577"
"1620","1578"
"1621","1581"
"1622","1583"
"1623","1575"
"1624","1578"
"1625","1581"
"1626","1583"
"1628","1578"
"1629","1581"
"1630","1585"
"1631","1574"
"1632","1575"
"1633","1576"
"1634","1577"
"1635","1578"
"1636","1579"
"1637","1580"
"1638","1581"
"1639","1582"
"1640","1583"
"1641","1584"
"1642","1585"
