":START_ID",":END_ID"
"1742","1741"
"1743","1742"
"1744","1743"
"1745","1744"
"1746","1745"
"1747","1746"
"1748","1747"
"1749","1748"
"1750","1749"
"1751","1750"
"1752","1751"
"1753","1752"
"1754","1753"
"1755","1754"
"1756","1755"
"1757","1756"
"1758","1757"
"1759","1758"
