":START_ID",":END_ID"
"1491","1449"
"1492","1449"
"1493","1450"
"1494","1450"
"1495","1451"
"1496","1450"
"1497","1452"
"1498","1453"
"1499","1453"
"1500","1454"
"1501","1454"
