":START_ID",":END_ID"
"3853","3854"
"3853","3855"
"3853","3856"
"3853","3857"
"3853","3858"
