":START_ID",":END_ID"
"1623","1560"
"1623","1561"
"1623","1562"
"1623","1563"
"1623","1564"
"1623","1565"
"1623","1566"
"1623","1567"
"1623","1568"
"1623","1569"
"1623","1570"
"1623","1571"
"1623","1572"
"1623","1573"
"1623","1574"
"1623","1575"
"1623","1576"
"1623","1577"
"1623","1578"
"1623","1579"
"1623","1580"
"1623","1581"
"1623","1582"
"1623","1583"
"1623","1584"
"1623","1585"
"1623","1586"
"1623","1587"
"1623","1588"
"1623","1589"
"1623","1590"
"1623","1591"
"1623","1592"
"1623","1593"
"1623","1594"
"1623","1595"
"1623","1596"
"1623","1597"
"1623","1598"
"1623","1599"
"1623","1600"
"1623","1601"
"1623","1602"
"1623","1603"
"1623","1604"
"1623","1605"
"1623","1606"
"1623","1607"
"1623","1608"
"1623","1609"
"1623","1610"
"1623","1611"
"1623","1612"
"1623","1613"
"1623","1614"
"1623","1615"
"1623","1616"
"1623","1617"
"1623","1618"
"1623","1619"
"1623","1620"
"1623","1621"
"1623","1622"
