":START_ID",":END_ID"
"1692","1679"
"1693","1679"
"1694","1679"
"1695","1679"
"1696","1679"
"1697","1679"
"1698","1681"
"1699","1690"
"1700","1679"
"1701","1679"
"1702","1680"
"1703","1681"
"1704","1682"
"1705","1690"
"1706","1679"
"1707","1682"
"1708","1690"
"1709","1679"
"1710","1682"
"1711","1690"
"1712","1679"
"1713","1680"
"1714","1681"
"1715","1682"
"1716","1683"
"1717","1686"
"1718","1688"
"1719","1690"
"1720","1679"
"1721","1682"
"1722","1690"
"1723","1679"
"1724","1682"
"1725","1683"
"1726","1686"
"1727","1688"
"1728","1680"
"1729","1683"
"1730","1686"
"1731","1688"
"1733","1683"
"1734","1686"
"1735","1690"
"1736","1679"
"1737","1680"
"1738","1681"
"1739","1682"
"1740","1683"
"1741","1684"
"1742","1685"
"1743","1686"
"1744","1687"
"1745","1688"
"1746","1689"
"1747","1690"
"1748","1679"
"1749","1679"
