":START_ID",":END_ID"
"1853","1790"
"1853","1791"
"1853","1792"
"1853","1793"
"1853","1794"
"1853","1795"
"1853","1796"
"1853","1797"
"1853","1798"
"1853","1799"
"1853","1800"
"1853","1801"
"1853","1802"
"1853","1803"
"1853","1804"
"1853","1805"
"1853","1806"
"1853","1807"
"1853","1808"
"1853","1809"
"1853","1810"
"1853","1811"
"1853","1812"
"1853","1813"
"1853","1814"
"1853","1815"
"1853","1816"
"1853","1817"
"1853","1818"
"1853","1819"
"1853","1820"
"1853","1821"
"1853","1822"
"1853","1823"
"1853","1824"
"1853","1825"
"1853","1826"
"1853","1827"
"1853","1828"
"1853","1829"
"1853","1830"
"1853","1831"
"1853","1832"
"1853","1833"
"1853","1834"
"1853","1835"
"1853","1836"
"1853","1837"
"1853","1838"
"1853","1839"
"1853","1840"
"1853","1841"
"1853","1842"
"1853","1843"
"1853","1844"
"1853","1845"
"1853","1846"
"1853","1847"
"1853","1848"
"1853","1849"
"1853","1850"
"1853","1851"
"1853","1852"
