":START_ID",":END_ID"
"1559","1513"
"1560","1514"
"1561","1513"
"1562","1514"
"1563","1513"
"1564","1514"
"1565","1513"
"1566","1513"
"1567","1514"
"1568","1513"
"1569","1514"
