":START_ID",":END_ID"
"1502","1531"
"1504","1532"
"1504","1534"
"1504","1534"
"1506","1535"
"1507","1536"
"1507","1537"
"1508","1527"
"1508","1528"
"1509","1525"
"1509","1526"
"1511","1538"
"1512","1539"
"1513","1529"
"1515","1530"
"1516","1540"
"1516","1541"
