":START_ID",":END_ID"
"1585","1591"
"1585","1592"
"1585","1593"
"1584","1594"
"1584","1595"
"1584","1596"
"1589","1598"
"1588","1599"
"1589","1600"
