":START_ID",":END_ID"
"1335","1438"
"1337","1439"
"1337","1440"
"1338","1441"
"1340","1442"
"1340","1443"
"1340","1444"
"1340","1445"
"1340","1446"
"1340","1447"
"1340","1448"
"1341","1449"
"1343","1450"
"1343","1451"
"1343","1452"
"1343","1453"
"1344","1454"
"1346","1455"
"1346","1456"
"1346","1457"
"1346","1458"
"1346","1459"
"1347","1460"
"1349","1461"
"1349","1462"
"1349","1463"
"1349","1464"
"1350","1465"
"1351","1466"
"1351","1467"
"1351","1468"
"1352","1469"
"1352","1470"
"1353","1471"
"1354","1472"
"1354","1473"
"1354","1474"
"1355","1475"
"1355","1476"
"1356","1477"
"1357","1478"
"1357","1479"
"1357","1480"
"1358","1481"
"1358","1482"
"1359","1483"
"1360","1484"
"1360","1485"
"1360","1486"
"1361","1487"
"1361","1488"
