":START_ID",":END_ID"
"1633","1652"
"1641","1653"
"1641","1654"
"1642","1653"
"1642","1654"
"1647","1656"
"1648","1657"
