":START_ID",":END_ID"
"1559","1517"
"1560","1517"
"1561","1518"
"1562","1518"
"1563","1519"
"1564","1518"
"1565","1520"
"1566","1521"
"1567","1521"
"1568","1522"
"1569","1522"
