":START_ID",":END_ID"
"1907","1844"
"1907","1845"
"1907","1846"
"1907","1847"
"1907","1848"
"1907","1849"
"1907","1850"
"1907","1851"
"1907","1852"
"1907","1853"
"1907","1854"
"1907","1855"
"1907","1856"
"1907","1857"
"1907","1858"
"1907","1859"
"1907","1860"
"1907","1861"
"1907","1862"
"1907","1863"
"1907","1864"
"1907","1865"
"1907","1866"
"1907","1867"
"1907","1868"
"1907","1869"
"1907","1870"
"1907","1871"
"1907","1872"
"1907","1873"
"1907","1874"
"1907","1875"
"1907","1876"
"1907","1877"
"1907","1878"
"1907","1879"
"1907","1880"
"1907","1881"
"1907","1882"
"1907","1883"
"1907","1884"
"1907","1885"
"1907","1886"
"1907","1887"
"1907","1888"
"1907","1889"
"1907","1890"
"1907","1891"
"1907","1892"
"1907","1893"
"1907","1894"
"1907","1895"
"1907","1896"
"1907","1897"
"1907","1898"
"1907","1899"
"1907","1900"
"1907","1901"
"1907","1902"
"1907","1903"
"1907","1904"
"1907","1905"
"1907","1906"
