":START_ID",":END_ID"
"1371","1335"
"1372","1336"
"1377","1337"
"1378","1338"
"1379","1339"
"1384","1340"
"1385","1341"
"1386","1342"
"1391","1343"
"1392","1344"
"1393","1345"
"1398","1346"
"1399","1347"
"1400","1348"
"1405","1349"
"1406","1350"
"1408","1351"
"1413","1352"
"1414","1353"
"1416","1354"
"1421","1355"
"1422","1356"
"1424","1357"
"1429","1358"
"1430","1359"
"1432","1360"
"1437","1361"
