":START_ID",":END_ID"
"3860","3869"
"3860","3868"
"3860","3871"
"3860","3870"
"3860","3867"
"3861","3863"
"3861","3864"
"3861","3865"
"3861","3862"
"3861","3866"
