":START_ID",":END_ID"
"1454","1394"
"1455","1395"
"1460","1396"
"1461","1397"
"1462","1398"
"1467","1399"
"1468","1400"
"1469","1401"
"1474","1402"
"1475","1403"
"1476","1404"
"1481","1405"
"1482","1406"
"1483","1407"
"1488","1408"
"1489","1409"
"1490","1410"
"1495","1411"
"1496","1412"
"1497","1413"
"1502","1414"
"1503","1415"
"1504","1416"
"1509","1417"
"1510","1418"
"1511","1419"
"1516","1420"
"1517","1421"
"1518","1422"
"1519","1423"
"1520","1424"
"1521","1425"
"1522","1426"
"1523","1427"
"1524","1428"
"1525","1429"
"1526","1430"
"1527","1431"
"1528","1432"
"1529","1433"
"1530","1434"
"1531","1435"
"1532","1436"
"1533","1437"
"1534","1438"
"1535","1439"
"1536","1440"
"1537","1441"
"1538","1442"
"1539","1443"
