":START_ID",":END_ID"
"1420","1374"
"1421","1375"
"1422","1374"
"1423","1375"
"1424","1374"
"1425","1375"
"1426","1374"
"1427","1374"
"1428","1375"
"1429","1374"
"1430","1375"
