":START_ID",":END_ID"
"1632","1640"
"1633","1641"
"1633","1642"
"1634","1643"
"1680","1656"
"1681","1657"
"1682","1658"
"1683","1659"
"1684","1660"
"1685","1661"
"1686","1662"
"1687","1663"
"1688","1664"
"1689","1665"
"1690","1666"
"1691","1667"
