":START_ID",":END_ID"
"3836","3819"
"3837","3820"
"3838","3821"
"3839","3822"
"3840","3823"
"3841","3824"
"3842","3825"
"3843","3826"
"3844","3827"
"3844","3828"
"3845","3829"
"3846","3830"
