":START_ID",":END_ID"
"1692","1629"
"1692","1630"
"1692","1631"
"1692","1632"
"1692","1633"
"1692","1634"
"1692","1635"
"1692","1636"
"1692","1637"
"1692","1638"
"1692","1639"
"1692","1640"
"1692","1641"
"1692","1642"
"1692","1643"
"1692","1644"
"1692","1645"
"1692","1646"
"1692","1647"
"1692","1648"
"1692","1649"
"1692","1650"
"1692","1651"
"1692","1652"
"1692","1653"
"1692","1654"
"1692","1655"
"1692","1656"
"1692","1657"
"1692","1658"
"1692","1659"
"1692","1660"
"1692","1661"
"1692","1662"
"1692","1663"
"1692","1664"
"1692","1665"
"1692","1666"
"1692","1667"
"1692","1668"
"1692","1669"
"1692","1670"
"1692","1671"
"1692","1672"
"1692","1673"
"1692","1674"
"1692","1675"
"1692","1676"
"1692","1677"
"1692","1678"
"1692","1679"
"1692","1680"
"1692","1681"
"1692","1682"
"1692","1683"
"1692","1684"
"1692","1685"
"1692","1686"
"1692","1687"
"1692","1688"
"1692","1689"
"1692","1690"
"1692","1691"
