":START_ID",":END_ID"
"1471","1458"
"1472","1458"
"1473","1458"
"1474","1458"
"1475","1458"
"1476","1458"
"1477","1460"
"1478","1469"
"1479","1458"
"1480","1458"
"1481","1459"
"1482","1460"
"1483","1461"
"1484","1469"
"1485","1458"
"1486","1461"
"1487","1469"
"1488","1458"
"1489","1461"
"1490","1469"
"1491","1458"
"1492","1459"
"1493","1460"
"1494","1461"
"1495","1462"
"1496","1465"
"1497","1467"
"1498","1469"
"1499","1458"
"1500","1461"
"1501","1469"
"1502","1458"
"1503","1461"
"1504","1462"
"1505","1465"
"1506","1467"
"1507","1459"
"1508","1462"
"1509","1465"
"1510","1467"
"1512","1462"
"1513","1465"
"1514","1469"
"1515","1458"
"1516","1459"
"1517","1460"
"1518","1461"
"1519","1462"
"1520","1463"
"1521","1464"
"1522","1465"
"1523","1466"
"1524","1467"
"1525","1468"
"1526","1469"
