":START_ID",":END_ID"
"1345","1346"
"1345","1347"
"1345","1348"
"1345","1349"
"1345","1350"
"1345","1351"
"1345","1352"
