":START_ID",":END_ID"
"1406","1414"
"1407","1415"
"1407","1416"
"1408","1417"
"1454","1430"
"1455","1431"
"1456","1432"
"1457","1433"
"1458","1434"
"1459","1435"
"1460","1436"
"1461","1437"
"1462","1438"
"1463","1439"
"1464","1440"
"1465","1441"
