":START_ID",":END_ID"
"1387","1346"
"1387","1347"
"1387","1348"
"1387","1349"
"1387","1350"
"1387","1351"
"1387","1352"
"1388","1353"
"1388","1354"
"1388","1355"
"1388","1356"
"1388","1357"
"1388","1358"
"1388","1359"
"1388","1360"
"1388","1361"
"1389","1362"
"1389","1363"
"1389","1364"
"1389","1365"
"1389","1366"
"1389","1367"
"1389","1368"
"1389","1369"
"1389","1370"
"1389","1371"
"1389","1372"
"1389","1373"
"1389","1374"
"1389","1375"
"1389","1376"
"1389","1377"
"1389","1378"
"1389","1379"
"1389","1380"
"1389","1381"
"1389","1382"
"1389","1383"
"1389","1384"
"1390","1385"
"1390","1386"
