":START_ID",":END_ID"
"1441","1494"
"1442","1495"
"1442","1496"
"1442","1497"
"1443","1498"
"1443","1499"
"1443","1500"
"1444","1501"
"1444","1502"
"1445","1503"
"1445","1504"
"1446","1505"
"1446","1506"
