":START_ID",":END_ID"
"3800","3783"
"3801","3784"
"3802","3785"
"3803","3786"
"3804","3787"
"3805","3788"
"3806","3789"
"3807","3790"
"3808","3791"
"3808","3792"
"3809","3793"
"3810","3794"
