":START_ID",":END_ID"
"1597","1771"
"1597","1772"
"1597","1773"
"1597","1774"
"1597","1775"
"1597","1776"
"1597","1778"
"1597","1779"
"1597","1780"
"1597","1781"
"1597","1782"
"1597","1784"
"1598","1777"
"1598","1783"
"1599","1771"
"1599","1772"
"1599","1773"
"1599","1774"
"1599","1775"
"1599","1776"
"1599","1778"
"1599","1779"
"1599","1780"
"1599","1781"
"1599","1782"
"1599","1784"
