":START_ID",":END_ID"
"1489","1553"
"1489","1554"
"1489","1555"
"1489","1556"
"1489","1557"
"1489","1558"
"1489","1559"
"1489","1560"
"1489","1561"
"1489","1562"
"1489","1563"
