":START_ID",":END_ID"
"1604","1668"
"1604","1669"
"1604","1670"
"1604","1671"
"1604","1672"
"1604","1673"
"1604","1674"
"1604","1675"
"1604","1676"
"1604","1677"
"1604","1678"
