":START_ID",":END_ID"
"1471","1527"
"1472","1528"
"1473","1529"
"1474","1530"
"1475","1531"
"1476","1532"
"1477","1532"
"1478","1532"
"1479","1533"
"1480","1534"
"1481","1534"
"1482","1534"
"1483","1534"
"1484","1534"
"1485","1535"
"1486","1535"
"1487","1535"
"1488","1536"
"1489","1536"
"1490","1536"
"1491","1537"
"1492","1537"
"1493","1537"
"1494","1537"
"1495","1537"
"1496","1537"
"1497","1537"
"1498","1537"
"1499","1538"
"1500","1538"
"1501","1538"
"1502","1539"
"1503","1539"
"1504","1540"
"1505","1540"
"1506","1540"
"1507","1541"
"1508","1541"
"1509","1541"
"1510","1541"
"1511","1542"
"1512","1542"
"1513","1542"
"1514","1542"
"1515","1543"
"1516","1543"
"1517","1543"
"1518","1543"
"1519","1543"
"1520","1543"
"1521","1543"
"1522","1543"
"1523","1543"
"1524","1543"
"1525","1543"
"1526","1543"
