":START_ID",":END_ID"
"1393","1564"
"1393","1565"
"1393","1566"
"1393","1567"
"1393","1568"
"1393","1569"
"1393","1571"
"1393","1572"
"1393","1573"
"1393","1574"
"1393","1575"
"1393","1577"
"1394","1570"
"1394","1576"
"1395","1564"
"1395","1565"
"1395","1566"
"1395","1567"
"1395","1568"
"1395","1569"
"1395","1571"
"1395","1572"
"1395","1573"
"1395","1574"
"1395","1575"
"1395","1577"
