":START_ID",":END_ID"
"1483","1437"
"1484","1438"
"1485","1437"
"1486","1438"
"1487","1437"
"1488","1438"
"1489","1437"
"1490","1437"
"1491","1438"
"1492","1437"
"1493","1438"
