":START_ID",":END_ID"
"1556","1520"
"1557","1520"
"1558","1521"
"1559","1522"
"1560","1521"
"1561","1522"
"1562","1521"
"1563","1521"
"1564","1522"
"1565","1523"
"1566","1523"
