":START_ID",":END_ID"
"1432","1531"
"1434","1532"
"1434","1533"
"1435","1534"
"1437","1535"
"1437","1536"
"1437","1537"
"1437","1538"
"1437","1539"
"1437","1540"
"1437","1541"
"1438","1542"
"1440","1543"
"1440","1544"
"1440","1545"
"1440","1546"
"1441","1547"
"1443","1548"
"1443","1549"
"1443","1550"
"1443","1551"
"1443","1552"
"1444","1553"
"1446","1554"
"1446","1555"
"1446","1556"
"1446","1557"
"1447","1558"
"1448","1559"
"1448","1560"
"1448","1561"
"1449","1562"
"1449","1563"
"1450","1564"
"1451","1565"
"1452","1566"
"1452","1567"
"1453","1568"
"1454","1569"
"1455","1570"
"1455","1571"
"1456","1572"
"1457","1573"
"1458","1574"
"1458","1575"
