":START_ID",":END_ID"
"1362","1479"
"1363","1479"
"1364","1479"
"1365","1479"
"1366","1479"
"1367","1479"
"1368","1479"
"1369","1479"
"1370","1479"
