":START_ID",":END_ID"
"1722","1778"
"1723","1779"
"1724","1780"
"1725","1781"
"1726","1782"
"1727","1783"
"1728","1783"
"1729","1783"
"1730","1784"
"1731","1785"
"1732","1785"
"1733","1785"
"1734","1785"
"1735","1785"
"1736","1786"
"1737","1786"
"1738","1786"
"1739","1787"
"1740","1787"
"1741","1787"
"1742","1788"
"1743","1788"
"1744","1788"
"1745","1788"
"1746","1788"
"1747","1788"
"1748","1788"
"1749","1788"
"1750","1789"
"1751","1789"
"1752","1789"
"1753","1790"
"1754","1790"
"1755","1791"
"1756","1791"
"1757","1791"
"1758","1792"
"1759","1792"
"1760","1792"
"1761","1792"
"1762","1793"
"1763","1793"
"1764","1793"
"1765","1793"
"1766","1794"
"1767","1794"
"1768","1794"
"1769","1794"
"1770","1794"
"1771","1794"
"1772","1794"
"1773","1794"
"1774","1794"
"1775","1794"
"1776","1794"
"1777","1794"
