":START_ID",":END_ID"
"1608","1661"
"1609","1662"
"1609","1663"
"1609","1664"
"1610","1665"
"1610","1666"
"1610","1667"
"1611","1668"
"1611","1669"
"1612","1670"
"1612","1671"
"1613","1672"
"1613","1673"
