":START_ID",":END_ID"
"1635","1654"
"1643","1655"
"1643","1656"
"1644","1655"
"1644","1656"
"1649","1658"
"1650","1659"
