":START_ID",":END_ID"
"1527","1546"
"1535","1547"
"1535","1548"
"1536","1547"
"1536","1548"
"1541","1550"
"1542","1551"
