":START_ID",":END_ID"
"3824","3833"
"3824","3832"
"3824","3835"
"3824","3834"
"3824","3831"
"3825","3827"
"3825","3828"
"3825","3829"
"3825","3826"
"3825","3830"
