":START_ID",":END_ID"
"1653","1829"
"1653","1830"
"1653","1831"
"1653","1832"
"1653","1833"
"1653","1834"
"1653","1836"
"1653","1837"
"1653","1838"
"1653","1839"
"1653","1840"
"1653","1842"
"1654","1835"
"1654","1841"
"1655","1829"
"1655","1830"
"1655","1831"
"1655","1832"
"1655","1833"
"1655","1834"
"1655","1836"
"1655","1837"
"1655","1838"
"1655","1839"
"1655","1840"
"1655","1842"
