":START_ID",":END_ID"
"1702","1656"
"1703","1657"
"1704","1656"
"1705","1657"
"1706","1656"
"1707","1657"
"1708","1656"
"1709","1656"
"1710","1657"
"1711","1656"
"1712","1657"
