":START_ID",":END_ID"
"1132","1118"
"1132","1119"
"1132","1120"
"1132","1121"
"1132","1122"
"1132","1123"
"1132","1124"
"1132","1125"
"1132","1126"
"1132","1127"
"1132","1128"
"1132","1129"
"1132","1130"
"1132","1131"
