":START_ID",":END_ID"
"1350","1417"
"1351","1417"
"1352","1417"
"1353","1417"
"1354","1417"
