":START_ID",":END_ID"
"1427","1491"
"1427","1492"
"1427","1493"
"1427","1494"
"1427","1495"
"1427","1496"
"1427","1497"
"1427","1498"
"1427","1499"
"1427","1500"
"1427","1501"
