":START_ID",":END_ID"
"1636","1644"
"1637","1645"
"1637","1646"
"1638","1647"
"1684","1660"
"1685","1661"
"1686","1662"
"1687","1663"
"1688","1664"
"1689","1665"
"1690","1666"
"1691","1667"
"1692","1668"
"1693","1669"
"1694","1670"
"1695","1671"
