":START_ID",":END_ID"
"1411","1415"
"1412","1416"
"1412","1417"
"1413","1418"
"1459","1423"
"1460","1424"
"1461","1425"
"1462","1426"
"1463","1427"
"1464","1428"
"1465","1429"
"1466","1430"
"1467","1431"
"1468","1432"
"1469","1433"
"1470","1434"
