":START_ID",":END_ID"
"1617","1796"
"1617","1797"
"1617","1798"
"1617","1799"
"1617","1800"
"1617","1801"
"1617","1803"
"1617","1804"
"1617","1805"
"1617","1806"
"1617","1807"
"1617","1809"
"1618","1802"
"1618","1808"
"1619","1796"
"1619","1797"
"1619","1798"
"1619","1799"
"1619","1800"
"1619","1801"
"1619","1803"
"1619","1804"
"1619","1805"
"1619","1806"
"1619","1807"
"1619","1809"
