":START_ID",":END_ID"
"1547","1501"
"1548","1502"
"1549","1501"
"1550","1502"
"1551","1501"
"1552","1502"
"1553","1501"
"1554","1501"
"1555","1502"
"1556","1501"
"1557","1502"
