":START_ID",":END_ID"
"1499","1563"
"1499","1564"
"1499","1565"
"1499","1566"
"1499","1567"
"1499","1568"
"1499","1569"
"1499","1570"
"1499","1571"
"1499","1572"
"1499","1573"
