":START_ID",":END_ID"
"3697","3684"
"3698","3685"
"3699","3686"
"3700","3687"
"3701","3688"
"3702","3689"
"3702","3690"
"3703","3691"
"3704","3692"
