":START_ID",":END_ID"
"1904","1841"
"1904","1842"
"1904","1843"
"1904","1844"
"1904","1845"
"1904","1846"
"1904","1847"
"1904","1848"
"1904","1849"
"1904","1850"
"1904","1851"
"1904","1852"
"1904","1853"
"1904","1854"
"1904","1855"
"1904","1856"
"1904","1857"
"1904","1858"
"1904","1859"
"1904","1860"
"1904","1861"
"1904","1862"
"1904","1863"
"1904","1864"
"1904","1865"
"1904","1866"
"1904","1867"
"1904","1868"
"1904","1869"
"1904","1870"
"1904","1871"
"1904","1872"
"1904","1873"
"1904","1874"
"1904","1875"
"1904","1876"
"1904","1877"
"1904","1878"
"1904","1879"
"1904","1880"
"1904","1881"
"1904","1882"
"1904","1883"
"1904","1884"
"1904","1885"
"1904","1886"
"1904","1887"
"1904","1888"
"1904","1889"
"1904","1890"
"1904","1891"
"1904","1892"
"1904","1893"
"1904","1894"
"1904","1895"
"1904","1896"
"1904","1897"
"1904","1898"
"1904","1899"
"1904","1900"
"1904","1901"
"1904","1902"
"1904","1903"
