":START_ID",":END_ID"
"1366","1430"
"1366","1431"
"1366","1432"
"1366","1433"
"1366","1434"
"1366","1435"
"1366","1436"
"1366","1437"
"1366","1438"
"1366","1439"
"1366","1440"
