":START_ID",":END_ID"
"29","30"
"29","31"
"29","32"
"34","35"
"35","36"
"35","37"
"34","38"
"34","29"
"34","39"
"34","40"
"40","41"
"40","42"
"40","43"
"34","44"
"44","45"
"34","46"
"46","47"
"46","48"
"46","49"
"46","43"
"34","50"
"34","51"
"52","53"
"52","54"
"52","55"
"52","56"
"52","57"
"52","39"
"52","58"
"52","59"
"52","29"
"52","60"
"52","61"
"52","62"
"52","63"
"52","64"
"52","65"
"65","66"
"65","67"
"65","68"
"52","33"
"52","44"
"44","45"
"52","69"
"69","70"
"69","71"
"52","72"
"52","73"
"73","74"
"73","75"
"73","76"
"73","77"
"73","78"
"73","79"
"80","81"
"80","33"
"80","63"
"80","58"
"80","51"
"80","82"
"80","83"
"80","84"
"80","85"
"85","86"
"85","87"
"80","88"
"80","89"
"80","90"
"80","91"
"91","92"
"91","93"
"91","94"
"80","29"
