":START_ID",":END_ID"
"1482","1492"
"1483","1499"
"1484","1506"
"1485","1513"
"1486","1520"
"1487","1527"
"1488","1534"
"1489","1541"
"1490","1548"
"1491","1555"
