":START_ID",":END_ID"
"1482","1488"
"1482","1489"
"1482","1490"
"1481","1491"
"1481","1492"
"1481","1493"
"1486","1495"
"1485","1496"
"1486","1497"
