":START_ID",":END_ID"
"1457","1468"
"1458","1475"
"1459","1479"
"1460","1482"
"1461","1489"
"1462","1492"
"1463","1499"
"1464","1506"
"1465","1513"
"1466","1520"
"1467","1543"
