":START_ID",":END_ID"
"1684","1742"
"1685","1743"
"1686","1744"
"1687","1745"
"1688","1746"
"1689","1747"
"1690","1747"
"1691","1747"
"1692","1748"
"1693","1749"
"1694","1749"
"1695","1749"
"1696","1749"
"1697","1749"
"1698","1750"
"1699","1750"
"1700","1750"
"1701","1751"
"1702","1751"
"1703","1751"
"1704","1752"
"1705","1752"
"1706","1752"
"1707","1752"
"1708","1752"
"1709","1752"
"1710","1752"
"1711","1752"
"1712","1753"
"1713","1753"
"1714","1753"
"1715","1754"
"1716","1754"
"1717","1755"
"1718","1755"
"1719","1755"
"1720","1756"
"1721","1756"
"1722","1756"
"1723","1756"
"1724","1757"
"1725","1757"
"1726","1757"
"1727","1757"
"1728","1758"
"1729","1758"
"1730","1758"
"1731","1758"
"1732","1758"
"1733","1758"
"1734","1758"
"1735","1758"
"1736","1758"
"1737","1758"
"1738","1758"
"1739","1758"
"1740","1759"
"1741","1761"
