":START_ID",":END_ID"
"1097","1087"
"1097","1088"
"1097","1089"
"1097","1090"
"1097","1091"
"1097","1092"
"1097","1093"
"1097","1094"
"1097","1095"
"1097","1096"
