":START_ID",":END_ID"
"1381","1552"
"1381","1553"
"1381","1554"
"1381","1555"
"1381","1556"
"1381","1557"
"1381","1559"
"1381","1560"
"1381","1561"
"1381","1562"
"1381","1563"
"1381","1565"
"1382","1558"
"1382","1564"
"1383","1552"
"1383","1553"
"1383","1554"
"1383","1555"
"1383","1556"
"1383","1557"
"1383","1559"
"1383","1560"
"1383","1561"
"1383","1562"
"1383","1563"
"1383","1565"
