":START_ID",":END_ID"
"1304","1181"
"1304","1182"
"1304","1183"
"1304","1184"
"1304","1185"
"1304","1186"
"1304","1187"
"1304","1188"
"1304","1189"
"1304","1190"
"1304","1191"
"1304","1192"
"1304","1193"
"1304","1194"
"1304","1195"
"1304","1196"
"1304","1197"
"1304","1198"
"1304","1199"
"1304","1200"
"1304","1201"
"1304","1202"
"1304","1203"
"1304","1204"
"1304","1205"
"1304","1206"
"1304","1207"
"1304","1208"
"1304","1209"
"1304","1210"
"1304","1211"
"1304","1212"
"1304","1213"
"1304","1214"
"1304","1215"
"1304","1216"
"1304","1217"
"1304","1218"
"1304","1219"
"1304","1220"
"1304","1221"
"1304","1222"
"1304","1223"
"1304","1224"
"1304","1225"
"1304","1226"
"1304","1227"
"1304","1228"
"1304","1229"
"1304","1230"
"1304","1231"
"1304","1232"
"1304","1233"
"1304","1234"
"1304","1235"
"1304","1236"
"1304","1237"
"1304","1238"
"1304","1239"
"1304","1240"
"1304","1241"
"1304","1242"
"1304","1243"
"1304","1244"
"1304","1245"
"1304","1246"
"1304","1247"
"1304","1248"
"1304","1249"
"1304","1250"
"1304","1251"
"1304","1252"
"1304","1253"
"1304","1254"
"1304","1255"
"1304","1256"
"1304","1257"
"1304","1258"
"1304","1259"
"1304","1260"
"1304","1261"
"1304","1262"
"1304","1263"
"1304","1264"
"1304","1265"
"1304","1266"
"1304","1267"
"1304","1268"
"1304","1269"
"1304","1270"
"1304","1271"
"1304","1272"
"1304","1273"
"1304","1274"
"1304","1275"
"1304","1276"
"1304","1277"
"1304","1278"
"1304","1279"
"1304","1280"
"1304","1281"
"1304","1282"
"1304","1283"
"1304","1284"
"1304","1285"
"1304","1286"
"1304","1287"
"1304","1288"
"1304","1289"
"1304","1290"
"1304","1291"
"1304","1292"
"1304","1293"
"1304","1294"
"1304","1295"
"1304","1296"
"1304","1297"
"1304","1298"
"1304","1299"
"1304","1300"
"1304","1301"
"1304","1302"
"1304","1303"
