":START_ID",":END_ID"
"1624","1632"
"1625","1633"
"1625","1634"
"1626","1635"
"1672","1648"
"1673","1649"
"1674","1650"
"1675","1651"
"1676","1652"
"1677","1653"
"1678","1654"
"1679","1655"
"1680","1656"
"1681","1657"
"1682","1658"
"1683","1659"
