":START_ID",":END_ID"
"1483","1547"
"1483","1548"
"1483","1549"
"1483","1550"
"1483","1551"
"1483","1552"
"1483","1553"
"1483","1554"
"1483","1555"
"1483","1556"
"1483","1557"
