":START_ID",":END_ID"
"3839","3822"
"3840","3823"
"3841","3824"
"3842","3825"
"3843","3826"
"3844","3827"
"3845","3828"
"3846","3829"
"3847","3830"
"3847","3831"
"3848","3832"
"3849","3833"
