":START_ID",":END_ID"
"3827","3836"
"3827","3835"
"3827","3838"
"3827","3837"
"3827","3834"
"3828","3830"
"3828","3831"
"3828","3832"
"3828","3829"
"3828","3833"
