":START_ID",":END_ID"
"1391","1348"
"1391","1349"
"1391","1350"
"1391","1351"
"1391","1352"
"1391","1353"
"1391","1354"
"1392","1355"
"1392","1356"
"1392","1357"
"1392","1358"
"1392","1359"
"1392","1360"
"1392","1361"
"1392","1362"
"1392","1363"
"1393","1364"
"1393","1365"
"1393","1366"
"1393","1367"
"1393","1368"
"1393","1369"
"1393","1370"
"1393","1371"
"1393","1372"
"1393","1373"
"1393","1374"
"1393","1375"
"1393","1376"
"1393","1377"
"1393","1378"
"1393","1379"
"1393","1380"
"1393","1381"
"1393","1382"
"1393","1383"
"1393","1384"
"1393","1385"
"1393","1386"
"1394","1387"
"1394","1388"
"1394","1389"
"1394","1390"
