":START_ID",":END_ID"
"1356","1420"
"1356","1421"
"1356","1422"
"1356","1423"
"1356","1424"
"1356","1425"
"1356","1426"
"1356","1427"
"1356","1428"
"1356","1429"
"1356","1430"
