":START_ID",":END_ID"
"1455","1464"
"1456","1471"
"1457","1478"
"1458","1485"
"1459","1492"
"1460","1499"
"1461","1506"
"1462","1513"
"1463","1520"
