":START_ID",":END_ID"
"1420","1378"
"1421","1378"
"1422","1379"
"1423","1379"
"1424","1380"
"1425","1379"
"1426","1381"
"1427","1382"
"1428","1382"
"1429","1383"
"1430","1383"
