":START_ID",":END_ID"
"1876","1813"
"1876","1814"
"1876","1815"
"1876","1816"
"1876","1817"
"1876","1818"
"1876","1819"
"1876","1820"
"1876","1821"
"1876","1822"
"1876","1823"
"1876","1824"
"1876","1825"
"1876","1826"
"1876","1827"
"1876","1828"
"1876","1829"
"1876","1830"
"1876","1831"
"1876","1832"
"1876","1833"
"1876","1834"
"1876","1835"
"1876","1836"
"1876","1837"
"1876","1838"
"1876","1839"
"1876","1840"
"1876","1841"
"1876","1842"
"1876","1843"
"1876","1844"
"1876","1845"
"1876","1846"
"1876","1847"
"1876","1848"
"1876","1849"
"1876","1850"
"1876","1851"
"1876","1852"
"1876","1853"
"1876","1854"
"1876","1855"
"1876","1856"
"1876","1857"
"1876","1858"
"1876","1859"
"1876","1860"
"1876","1861"
"1876","1862"
"1876","1863"
"1876","1864"
"1876","1865"
"1876","1866"
"1876","1867"
"1876","1868"
"1876","1869"
"1876","1870"
"1876","1871"
"1876","1872"
"1876","1873"
"1876","1874"
"1876","1875"
