":START_ID",":END_ID"
"1555","1519"
"1556","1519"
"1557","1520"
"1558","1521"
"1559","1520"
"1560","1521"
"1561","1520"
"1562","1520"
"1563","1521"
"1564","1522"
"1565","1522"
