":START_ID",":END_ID"
"1357","1358"
"1357","1359"
"1357","1360"
"1357","1361"
"1357","1362"
"1357","1363"
"1357","1364"
