":START_ID",":END_ID"
"1632","1569"
"1632","1570"
"1632","1571"
"1632","1572"
"1632","1573"
"1632","1574"
"1632","1575"
"1632","1576"
"1632","1577"
"1632","1578"
"1632","1579"
"1632","1580"
"1632","1581"
"1632","1582"
"1632","1583"
"1632","1584"
"1632","1585"
"1632","1586"
"1632","1587"
"1632","1588"
"1632","1589"
"1632","1590"
"1632","1591"
"1632","1592"
"1632","1593"
"1632","1594"
"1632","1595"
"1632","1596"
"1632","1597"
"1632","1598"
"1632","1599"
"1632","1600"
"1632","1601"
"1632","1602"
"1632","1603"
"1632","1604"
"1632","1605"
"1632","1606"
"1632","1607"
"1632","1608"
"1632","1609"
"1632","1610"
"1632","1611"
"1632","1612"
"1632","1613"
"1632","1614"
"1632","1615"
"1632","1616"
"1632","1617"
"1632","1618"
"1632","1619"
"1632","1620"
"1632","1621"
"1632","1622"
"1632","1623"
"1632","1624"
"1632","1625"
"1632","1626"
"1632","1627"
"1632","1628"
"1632","1629"
"1632","1630"
"1632","1631"
