":START_ID",":END_ID"
"1491","1492"
"1491","1493"
"1491","1494"
"1491","1492"
"1491","1493"
"1491","1494"
