":START_ID",":END_ID"
"1519","1523"
"1520","1524"
"1520","1525"
"1521","1526"
"1567","1531"
"1568","1532"
"1569","1533"
"1570","1534"
"1571","1535"
"1572","1536"
"1573","1537"
"1574","1538"
"1575","1539"
"1576","1540"
"1577","1541"
"1578","1542"
