":START_ID",":END_ID"
"1637","1701"
"1637","1702"
"1637","1703"
"1637","1704"
"1637","1705"
"1637","1706"
"1637","1707"
"1637","1708"
"1637","1709"
"1637","1710"
"1637","1711"
