":START_ID",":END_ID"
"1505","1534"
"1507","1535"
"1507","1537"
"1507","1537"
"1509","1538"
"1510","1539"
"1510","1540"
"1511","1530"
"1511","1531"
"1512","1528"
"1512","1529"
"1514","1541"
"1515","1542"
"1516","1532"
"1518","1533"
"1519","1543"
"1519","1544"
