":START_ID",":END_ID"
"3834","3835"
"3834","3836"
"3834","3837"
"3834","3838"
"3834","3839"
"3834","3840"
