":START_ID",":END_ID"
"1495","1559"
"1495","1560"
"1495","1561"
"1495","1562"
"1495","1563"
"1495","1564"
"1495","1565"
"1495","1566"
"1495","1567"
"1495","1568"
"1495","1569"
