":START_ID",":END_ID"
"1636","1642"
"1636","1643"
"1636","1644"
"1635","1645"
"1635","1646"
"1635","1647"
"1640","1649"
"1639","1650"
"1640","1651"
