":START_ID",":END_ID"
"1623","1802"
"1623","1803"
"1623","1804"
"1623","1805"
"1623","1806"
"1623","1807"
"1623","1809"
"1623","1810"
"1623","1811"
"1623","1812"
"1623","1813"
"1623","1815"
"1624","1808"
"1624","1814"
"1625","1802"
"1625","1803"
"1625","1804"
"1625","1805"
"1625","1806"
"1625","1807"
"1625","1809"
"1625","1810"
"1625","1811"
"1625","1812"
"1625","1813"
"1625","1815"
