":START_ID",":END_ID"
"1523","1531"
"1524","1532"
"1524","1533"
"1525","1534"
"1571","1547"
"1572","1548"
"1573","1549"
"1574","1550"
"1575","1551"
"1576","1552"
"1577","1553"
"1578","1554"
"1579","1555"
"1580","1556"
"1581","1557"
"1582","1558"
