":START_ID",":END_ID"
"1364","1373"
"1364","1374"
"1364","1375"
"1364","1376"
"1364","1377"
"1364","1378"
"1364","1379"
"1365","1380"
"1365","1381"
"1365","1382"
"1365","1383"
"1365","1384"
"1365","1385"
"1365","1386"
"1366","1387"
"1366","1388"
"1366","1389"
"1366","1390"
"1366","1391"
"1366","1392"
"1366","1393"
"1367","1394"
"1367","1395"
"1367","1396"
"1367","1397"
"1367","1398"
"1367","1399"
"1367","1400"
"1368","1401"
"1368","1402"
"1368","1403"
"1368","1404"
"1368","1405"
"1368","1406"
"1368","1407"
"1369","1408"
"1369","1409"
"1369","1410"
"1369","1411"
"1369","1412"
"1369","1413"
"1369","1414"
"1370","1415"
"1370","1416"
"1370","1417"
"1370","1418"
"1370","1419"
"1370","1420"
"1370","1421"
"1371","1422"
"1371","1423"
"1371","1424"
"1371","1425"
"1371","1426"
"1371","1427"
"1371","1428"
"1372","1429"
"1372","1430"
"1372","1431"
"1372","1432"
"1372","1433"
"1372","1434"
"1372","1435"
