":START_ID",":END_ID"
"1394","1540"
"1396","1541"
"1396","1542"
"1397","1543"
"1399","1544"
"1399","1545"
"1399","1546"
"1399","1547"
"1399","1548"
"1399","1549"
"1399","1550"
"1400","1551"
"1402","1552"
"1402","1553"
"1402","1554"
"1402","1555"
"1403","1556"
"1405","1557"
"1405","1558"
"1405","1559"
"1405","1560"
"1405","1561"
"1406","1562"
"1408","1563"
"1408","1564"
"1408","1565"
"1408","1566"
"1409","1567"
"1410","1568"
"1410","1569"
"1410","1570"
"1411","1571"
"1411","1572"
"1412","1573"
"1413","1574"
"1414","1575"
"1414","1576"
"1415","1577"
"1416","1578"
"1417","1579"
"1417","1580"
"1418","1581"
"1419","1582"
"1420","1583"
"1420","1584"
"1421","1585"
