":START_ID",":END_ID"
"1749","1748"
"1750","1749"
"1751","1750"
"1752","1751"
"1753","1752"
"1754","1753"
"1755","1754"
"1756","1755"
"1757","1756"
"1758","1757"
"1759","1758"
"1760","1759"
"1761","1760"
"1762","1761"
"1763","1762"
"1764","1763"
"1765","1764"
"1766","1765"
