":START_ID",":END_ID"
"1447","1434"
"1448","1434"
"1449","1434"
"1450","1434"
"1451","1434"
"1452","1434"
"1453","1436"
"1454","1445"
"1455","1434"
"1456","1434"
"1457","1435"
"1458","1436"
"1459","1437"
"1460","1445"
"1461","1434"
"1462","1437"
"1463","1445"
"1464","1434"
"1465","1437"
"1466","1445"
"1467","1434"
"1468","1435"
"1469","1436"
"1470","1437"
"1471","1438"
"1472","1441"
"1473","1443"
"1474","1445"
"1475","1434"
"1476","1437"
"1477","1445"
"1478","1434"
"1479","1437"
"1480","1438"
"1481","1441"
"1482","1443"
"1483","1435"
"1484","1438"
"1485","1441"
"1486","1443"
"1488","1438"
"1489","1441"
"1490","1445"
"1491","1434"
"1492","1435"
"1493","1436"
"1494","1437"
"1495","1438"
"1496","1439"
"1497","1440"
"1498","1441"
"1499","1442"
"1500","1443"
"1501","1444"
"1502","1445"
