":START_ID",":END_ID"
"1547","1505"
"1548","1505"
"1549","1506"
"1550","1506"
"1551","1507"
"1552","1506"
"1553","1508"
"1554","1509"
"1555","1509"
"1556","1510"
"1557","1510"
