":START_ID",":END_ID"
"3803","3786"
"3804","3787"
"3805","3788"
"3806","3789"
"3807","3790"
"3808","3791"
"3809","3792"
"3810","3793"
"3811","3794"
"3811","3795"
"3812","3796"
"3813","3797"
