":START_ID",":END_ID"
"1093","1083"
"1093","1084"
"1093","1085"
"1093","1086"
"1093","1087"
"1093","1088"
"1093","1089"
"1093","1090"
"1093","1091"
"1093","1092"
