":START_ID",":END_ID"
"1865","1802"
"1865","1803"
"1865","1804"
"1865","1805"
"1865","1806"
"1865","1807"
"1865","1808"
"1865","1809"
"1865","1810"
"1865","1811"
"1865","1812"
"1865","1813"
"1865","1814"
"1865","1815"
"1865","1816"
"1865","1817"
"1865","1818"
"1865","1819"
"1865","1820"
"1865","1821"
"1865","1822"
"1865","1823"
"1865","1824"
"1865","1825"
"1865","1826"
"1865","1827"
"1865","1828"
"1865","1829"
"1865","1830"
"1865","1831"
"1865","1832"
"1865","1833"
"1865","1834"
"1865","1835"
"1865","1836"
"1865","1837"
"1865","1838"
"1865","1839"
"1865","1840"
"1865","1841"
"1865","1842"
"1865","1843"
"1865","1844"
"1865","1845"
"1865","1846"
"1865","1847"
"1865","1848"
"1865","1849"
"1865","1850"
"1865","1851"
"1865","1852"
"1865","1853"
"1865","1854"
"1865","1855"
"1865","1856"
"1865","1857"
"1865","1858"
"1865","1859"
"1865","1860"
"1865","1861"
"1865","1862"
"1865","1863"
"1865","1864"
