":START_ID",":END_ID"
"1387","1391"
"1388","1392"
"1388","1393"
"1389","1394"
"1435","1399"
"1436","1400"
"1437","1401"
"1438","1402"
"1439","1403"
"1440","1404"
"1441","1405"
"1442","1406"
"1443","1407"
"1444","1408"
"1445","1409"
"1446","1410"
