":START_ID",":END_ID"
"1646","1600"
"1647","1601"
"1648","1600"
"1649","1601"
"1650","1600"
"1651","1601"
"1652","1600"
"1653","1600"
"1654","1601"
"1655","1600"
"1656","1601"
