":START_ID",":END_ID"
"3828","3837"
"3828","3836"
"3828","3839"
"3828","3838"
"3828","3835"
"3829","3831"
"3829","3832"
"3829","3833"
"3829","3830"
"3829","3834"
