":START_ID",":END_ID"
"1529","1558"
"1531","1559"
"1531","1561"
"1531","1561"
"1533","1562"
"1534","1563"
"1534","1564"
"1535","1554"
"1535","1555"
"1536","1552"
"1536","1553"
"1538","1565"
"1539","1566"
"1540","1556"
"1542","1557"
"1543","1567"
"1543","1568"
