":START_ID",":END_ID"
"1398","1569"
"1398","1570"
"1398","1571"
"1398","1572"
"1398","1573"
"1398","1574"
"1398","1576"
"1398","1577"
"1398","1578"
"1398","1579"
"1398","1580"
"1398","1582"
"1399","1575"
"1399","1581"
"1400","1569"
"1400","1570"
"1400","1571"
"1400","1572"
"1400","1573"
"1400","1574"
"1400","1576"
"1400","1577"
"1400","1578"
"1400","1579"
"1400","1580"
"1400","1582"
