":START_ID",":END_ID"
"1374","1338"
"1375","1339"
"1380","1340"
"1381","1341"
"1382","1342"
"1387","1343"
"1388","1344"
"1389","1345"
"1394","1346"
"1395","1347"
"1396","1348"
"1401","1349"
"1402","1350"
"1403","1351"
"1408","1352"
"1409","1353"
"1410","1354"
"1415","1355"
"1416","1356"
"1417","1357"
"1422","1358"
"1423","1359"
"1424","1360"
"1429","1361"
"1430","1362"
"1431","1363"
"1436","1364"
