":START_ID",":END_ID"
"1696","1683"
"1697","1683"
"1698","1683"
"1699","1683"
"1700","1683"
"1701","1683"
"1702","1685"
"1703","1694"
"1704","1683"
"1705","1683"
"1706","1684"
"1707","1685"
"1708","1686"
"1709","1694"
"1710","1683"
"1711","1686"
"1712","1694"
"1713","1683"
"1714","1686"
"1715","1694"
"1716","1683"
"1717","1684"
"1718","1685"
"1719","1686"
"1720","1687"
"1721","1690"
"1722","1692"
"1723","1694"
"1724","1683"
"1725","1686"
"1726","1694"
"1727","1683"
"1728","1686"
"1729","1687"
"1730","1690"
"1731","1692"
"1732","1684"
"1733","1687"
"1734","1690"
"1735","1692"
"1737","1687"
"1738","1690"
"1739","1694"
"1740","1683"
"1741","1684"
"1742","1685"
"1743","1686"
"1744","1687"
"1745","1688"
"1746","1689"
"1747","1690"
"1748","1691"
"1749","1692"
"1750","1693"
"1751","1694"
"1752","1683"
"1753","1683"
