":START_ID",":END_ID"
"1691","1628"
"1691","1629"
"1691","1630"
"1691","1631"
"1691","1632"
"1691","1633"
"1691","1634"
"1691","1635"
"1691","1636"
"1691","1637"
"1691","1638"
"1691","1639"
"1691","1640"
"1691","1641"
"1691","1642"
"1691","1643"
"1691","1644"
"1691","1645"
"1691","1646"
"1691","1647"
"1691","1648"
"1691","1649"
"1691","1650"
"1691","1651"
"1691","1652"
"1691","1653"
"1691","1654"
"1691","1655"
"1691","1656"
"1691","1657"
"1691","1658"
"1691","1659"
"1691","1660"
"1691","1661"
"1691","1662"
"1691","1663"
"1691","1664"
"1691","1665"
"1691","1666"
"1691","1667"
"1691","1668"
"1691","1669"
"1691","1670"
"1691","1671"
"1691","1672"
"1691","1673"
"1691","1674"
"1691","1675"
"1691","1676"
"1691","1677"
"1691","1678"
"1691","1679"
"1691","1680"
"1691","1681"
"1691","1682"
"1691","1683"
"1691","1684"
"1691","1685"
"1691","1686"
"1691","1687"
"1691","1688"
"1691","1689"
"1691","1690"
