":START_ID",":END_ID"
"32","19"
"33","20"
"34","21"
"36","22"
"37","23"
"38","24"
"52","25"
"58","26"
"76","27"
"76","28"
"93","29"
