":START_ID",":END_ID"
"1498","1504"
"1498","1505"
"1498","1506"
"1497","1507"
"1497","1508"
"1497","1509"
"1502","1511"
"1501","1512"
"1502","1513"
