":START_ID",":END_ID"
"1491","1445"
"1492","1446"
"1493","1445"
"1494","1446"
"1495","1445"
"1496","1446"
"1497","1445"
"1498","1445"
"1499","1446"
"1500","1445"
"1501","1446"
