":START_ID",":END_ID"
"1459","1468"
"1459","1469"
"1459","1470"
"1459","1471"
"1459","1472"
"1459","1473"
"1459","1474"
"1460","1475"
"1460","1476"
"1460","1477"
"1460","1478"
"1460","1479"
"1460","1480"
"1460","1481"
"1461","1482"
"1461","1483"
"1461","1484"
"1461","1485"
"1461","1486"
"1461","1487"
"1461","1488"
"1462","1489"
"1462","1490"
"1462","1491"
"1462","1492"
"1462","1493"
"1462","1494"
"1462","1495"
"1463","1496"
"1463","1497"
"1463","1498"
"1463","1499"
"1463","1500"
"1463","1501"
"1463","1502"
"1464","1503"
"1464","1504"
"1464","1505"
"1464","1506"
"1464","1507"
"1464","1508"
"1464","1509"
"1465","1510"
"1465","1511"
"1465","1512"
"1465","1513"
"1465","1514"
"1465","1515"
"1465","1516"
"1466","1517"
"1466","1518"
"1466","1519"
"1466","1520"
"1466","1521"
"1466","1522"
"1466","1523"
"1467","1524"
"1467","1525"
"1467","1526"
"1467","1527"
"1467","1528"
"1467","1529"
"1467","1530"
