":START_ID",":END_ID"
"1666","1630"
"1667","1630"
"1668","1631"
"1669","1632"
"1670","1631"
"1671","1632"
"1672","1631"
"1673","1631"
"1674","1632"
"1675","1633"
"1676","1633"
