":START_ID",":END_ID"
"1444","1454"
"1444","1455"
"1444","1456"
"1444","1457"
"1444","1458"
"1444","1459"
"1444","1460"
"1445","1461"
"1445","1462"
"1445","1463"
"1445","1464"
"1445","1465"
"1445","1466"
"1445","1467"
"1446","1468"
"1446","1469"
"1446","1470"
"1446","1471"
"1446","1472"
"1446","1473"
"1446","1474"
"1447","1475"
"1447","1476"
"1447","1477"
"1447","1478"
"1447","1479"
"1447","1480"
"1447","1481"
"1448","1482"
"1448","1483"
"1448","1484"
"1448","1485"
"1448","1486"
"1448","1487"
"1448","1488"
"1449","1489"
"1449","1490"
"1449","1491"
"1449","1492"
"1449","1493"
"1449","1494"
"1449","1495"
"1450","1496"
"1450","1497"
"1450","1498"
"1450","1499"
"1450","1500"
"1450","1501"
"1450","1502"
"1451","1503"
"1451","1504"
"1451","1505"
"1451","1506"
"1451","1507"
"1451","1508"
"1451","1509"
"1452","1510"
"1452","1511"
"1452","1512"
"1452","1513"
"1452","1514"
"1452","1515"
"1452","1516"
"1453","1517"
"1453","1518"
"1453","1519"
"1453","1520"
"1453","1521"
"1453","1522"
"1453","1523"
"1453","1524"
"1453","1525"
"1453","1526"
"1453","1527"
"1453","1528"
"1453","1529"
"1453","1530"
"1453","1531"
"1453","1532"
"1453","1533"
"1453","1534"
"1453","1535"
"1453","1536"
"1453","1537"
"1453","1538"
"1453","1539"
