":START_ID",":END_ID"
"1906","1843"
"1906","1844"
"1906","1845"
"1906","1846"
"1906","1847"
"1906","1848"
"1906","1849"
"1906","1850"
"1906","1851"
"1906","1852"
"1906","1853"
"1906","1854"
"1906","1855"
"1906","1856"
"1906","1857"
"1906","1858"
"1906","1859"
"1906","1860"
"1906","1861"
"1906","1862"
"1906","1863"
"1906","1864"
"1906","1865"
"1906","1866"
"1906","1867"
"1906","1868"
"1906","1869"
"1906","1870"
"1906","1871"
"1906","1872"
"1906","1873"
"1906","1874"
"1906","1875"
"1906","1876"
"1906","1877"
"1906","1878"
"1906","1879"
"1906","1880"
"1906","1881"
"1906","1882"
"1906","1883"
"1906","1884"
"1906","1885"
"1906","1886"
"1906","1887"
"1906","1888"
"1906","1889"
"1906","1890"
"1906","1891"
"1906","1892"
"1906","1893"
"1906","1894"
"1906","1895"
"1906","1896"
"1906","1897"
"1906","1898"
"1906","1899"
"1906","1900"
"1906","1901"
"1906","1902"
"1906","1903"
"1906","1904"
"1906","1905"
