":START_ID",":END_ID"
"1635","1664"
"1635","1675"
"1635","1676"
"1635","1677"
"1637","1665"
"1637","1667"
"1637","1667"
"1639","1668"
"1640","1669"
"1640","1670"
"1641","1660"
"1641","1661"
"1642","1658"
"1642","1659"
"1644","1671"
"1645","1672"
"1646","1662"
"1648","1663"
"1649","1673"
"1649","1674"
