":START_ID",":END_ID"
"1586","1650"
"1586","1651"
"1586","1652"
"1586","1653"
"1586","1654"
"1586","1655"
"1586","1656"
"1586","1657"
"1586","1658"
"1586","1659"
"1586","1660"
